Amendment	n.宪法修正案
Cuban	n./adj.古巴人；古巴（人）的
Ford	n.福特汽车公司
Hispanic	adj.西班牙的
Scotch	adj.苏格兰的
abandon	vt.抛弃；放弃 n.放纵；沉溺
abandoned	adj.被抛弃的，废置的
abandonment	n.抛弃；放弃
abbreviate	vt.缩短；缩写
abbreviation	n.缩写；缩写词
abide	vi.遵守 vt.忍受
abiding	adj.持久的
ability	n.能力，才干
ablaze	adj.着火的，闪耀的
abnormal	adj.反常的，变态的
aboard	prep./adv.在（船、飞机、车）上/上（船、飞机、车）
abolish	vt.废除，取消
abolition	n.废除，取消
abolitionist	n.废奴主义者
abort	n.中止计划（任务）
abound	vi.充满；富于
abrasion	n.磨（擦）破；表面磨损
abrasive	adj.研磨的
abrupt	adj.突然的，意外的
absence	n.缺少；不在，缺席
absent	adj.缺少的；不在的，缺席的
absentee	n.缺席者
absenteeism	n.旷课；旷工
absolute	adj.完全的；绝对的
absolutely	adv.完全地；绝对地
absorb	vt.吸收（液体、知识）
absorption	n.吸收
abstract	adj.抽象的 n/vt摘要，提炼
absurd	adj.荒谬的，可笑的
abundance	n.丰富，充裕
abundant	adj.丰富的，充裕的；大量的
abundantly	adv.丰富地
abuse	vt.滥用；虐待
abut	vi.邻接，毗邻
academic	adj.学术的；学院的；理论的
academician	n.学会会员；院士；学者
accelerate	v.加快，加速
accelerated	adj.加速的，迅速的
accelerating	adj.加速的
acceleration	n.加速度
access	n.接触，接近（的机会） n.入口，通道
accessibility	n.易接近；可达到
accessible	adj.可接近的，可接触的；可得到的
accessory	n.附件，零件
accident	n.意外事件，事故
accidental	adj.意外的，偶然的
accidentally	adv.意外地，偶然地
acclaim	n.赞誉，赞许 vt.喝彩，欢呼；称赞
acclaimed	adj.受人欢迎的
accommodate	vt.为提供食宿；与相符，与相适应
accommodating	adj.乐于助人的
accompaniment	n.伴奏
accompany	vt.陪伴，伴随；伴奏
accompanying	adj.陪伴的，伴随的
accomplish	vt.完成，达到，实现
accomplished	adj.精通的，熟练的
accomplishment	n.成就
accordion	n.手风琴
account	n.说明，解释 n.户头，账户 vi.解释
accountant	n.会计员，会计师
accounting	n.会计学
accredit	vt.授权
accumulate	vi.堆积，积聚；积累
accumulation	n.积聚
accuracy	n.准确性，正确性
accurate	adj.准确的，正确的
accusation	n.谴责；控告
accuse	vt.指责，归咎
accustomed	adj.通常的，习惯的
achieve	vt.完成，实现
achievement	n.成就，功绩
acid	n.酸 adj.酸的 adj.尖酸的，刻薄的
acidic	adj.酸的，酸性的
acidity	n.酸度，酸性
acquaint	vt.使熟知，通知
acquaintance	n.相识，熟人
acquainted	adj.有知识的，知晓的
acquire	vt.获得，学到
acquisition	n.获得
acronym	n.首字母缩写词
activate	vt.刺激，使活动
actively	adv.活跃地，积极地
actual	adj.实际的，现行的
actually	adv.实际上，事实上
actuate	vt.开动，促使
acumen	n.敏锐，聪明
acupuncture	n.针刺；针灸
acute	adj.灵敏的，敏锐的 adj.剧烈的；很严重的
adapt	v.（使）适应，调整；改编
adaptable	adj.能适应的，适应能力强的
adaptation	n.改编，改写；适应环境
adaptive	adj.适合的；适应的
addict	vt.使上瘾，使沉溺 n.上瘾的人
addictive	adj.（使人）上瘾的
additional	adj.另外的，附加的，额外的
additive	n.添加剂 adj.加法的
adept	adj.熟练的，拿手的
adequate	adj.足够的，充实的
adhere	vi.黏附，粘牢 vi.追随，坚持
adhesive	n.粘着物 adj.粘着的
adjacent	adj.毗连的，邻近的
adjoin	vt.毗连，邻近
adjoining	adj.毗邻的
adjunct	n.附件，附属
adjust	vt.调整；使适于
adjustment	n.调整
administer	vt.管理
administration	n.经营，管理 n.当局，政府
administrative	adj.管理的；行政的
administrator	n.管理者；行政官
admiration	n.钦佩，赞美
admire	vt.钦佩，崇拜；欣赏
admit	vt.准许进入 vt.承认
admittedly	adv.公认地；诚然，无可否认地
adobe	n.泥砖，土坯
adolescent	n.青少年
adopt	vt.采用，采纳 vt.收养
adoption	n.采用
adorn	vt.装饰
adornment	n.装饰；装饰品
advance	vt.提高，发展；提升 vt.提出 vi.前进 n.前进，进步 n.预先，提前（in advance）
advanced	adj.高级的；年老的；先进的
advancement	n.进展；提升
advent	n.出现，到来
adventure	n.冒险，冒险的经历
adventurer	n.冒险家
adventurous	adj.喜欢冒险的，敢做敢为的
adverse	adj.不利的；敌对的；相反地
adversely	adv.相反地；不利地
adversity	n.不幸，灾难
advocate	n.提倡者，主张者，拥护者 vt.拥护，主张
aerodynamics	n.空气动力学
aesthetic	adj.美学的，审美的
affect	v.影响；假装
affected	adj.装模作样的
affection	n.友爱，挚爱，情爱
affectionate	adj.亲爱的，挚爱的
affective	adj.感情的，表达感情的
affiliate	vt.使隶属；接纳为成员
affinity	n.紧密关系 n.吸引；喜爱
affirm	vt.断言；证实，确认
afflict	vt.（外来到）折磨
affliction	n.痛苦，苦恼
affluent	adj.富有的，丰富的
afford	vt.付得起；冒险做 vt.提供
affordable	adj.负担得起的，便宜的
agenda	n.日程，议程
aggravate	vt.使恶化，使加重
aggravating	adj.恼人的，讨厌的
aggregate	n.总数 n.聚集体
aggregation	n.集合，群体
aggressive	adj.强有力的，坚持己见的 adj.好斗的，有敌意的
aggressiveness	n.侵略；争斗
agile	adj.敏捷的，活泼轻快的
agility	n.敏捷，活泼
agitation	n.焦虑，不安；煽动
agreeable	adj.使人愉快的，合意的 adj.容易相处的
agriculture	n.农业，农艺，农学
ailment	n.疾病（尤指轻病、小病）
aim	n.目标，计划 vi.针对；打算，意欲
air	n.空气，空中 vt.晾干，使通风
airborne	adj.空气传播的；空运的，空降的
aircraft	n.航行器
airsickness	n.晕机
ajar	adj.（门窗等）微开的
akin	adj.同族的；类似的
alchemy	n.炼金术
alder	n.赤杨树
alert	adj.机敏的 vt.警报；使随时掌握、了解 n.警戒，警报
algae	n.海藻
alien	adj.相异的；陌生的
alignment	n.排列；联合，联盟
alike	adj.相同的，相似的
allegation	n.宣称，主张，断言
allegory	n.寓言
alliteration	n.（诗歌的）头韵
allocate	vt.分配
alloy	n.合金 vt.使成合金
allude	vi.暗指，影射，间接提到
ally	n.联盟；同盟者 v.结盟
aloft	adv.在高处；在空中
alone	adj./v.单独的（地）
aloof	adj.远离的；冷淡的，漠不关心的
alter	vt.改变，修改
alteration	n.变更，改造
alternate	adj.交替的，轮流的 adj.替代的 vi.交替，轮流
alternately	adv.交替地，隔一个地
alternation	n.交替，轮流
alternative	adj.另一可选的，另外的 n.可选事物，另一种选择
altitude	n.高度
aluminum	n.铝
amateur	adj.业余的 n.业余爱好者
amaze	vt.使吃惊，使惊叹
amazement	n.惊愕，惊异
amazing	adj.令人惊异的
ambience	n.周围环境，气氛
ambition	n.雄心，抱负
ambitious	adj.有雄心的，渴望成功的
ambivalence	n.矛盾心理
ambivalent	adj.有矛盾情绪的，举棋不定的
amble	vi.缓行，漫步
amenable	adj.顺从的；应服从的
amend	vt.改正，修正
amendment	n.改善，改正
amenity	n.pl.生活福利设施，文娱康乐场所 n.（不可数）愉快，适意
amid	prep.在…中
amnesia	n.健忘症
amount	n.量，总合 vi.总计；等于
ample	adj.富足的，充足的
amplification	n.扩大
amplify	vt.放大；扩大；增强
analogous	adj.类似的
analogy	n.类比，类推 n.类此物
analysis	n.分析；分析报告
analyze	vt.分析，分解
anarchist	n.无政府主义者
anatomy	n.解剖；解剖学
ancestor	n.祖先，祖宗
ancestral	adj.祖先的，祖传的
ancestry	n.家系，血统
anecdotal	adj.轶闻的，多轶闻趣闻的
anecdote	n.短故事，轶事
anesthesia	n.麻醉
anesthetic	n.麻醉剂，麻药
angular	adj.有角的，尖角的
animated	adj.活生生的；活泼的，生动的
annex	vt.兼并，附加
annihilate	vt.消灭；消减
announce	vt.宣布，通告
announcement	n.宣告，发表
announcer	n.广播员；报幕员
annoy	vt.使恼怒；打扰
annoying	adj.恼人的，讨厌的；使人愤怒的
annual	adj.每年的
annually	adv.一年一次，每年
anomaly	n.异常，不规则；异常的人或物
anonymous	adj.匿名的
antedate	vt.填早...的日期
anthem	n.圣歌，赞美诗
anthology	n.诗集，文选
anthropology	n.人类学
antibiotic	adj.抗菌的，抗生的 n.antibiotics 抗生素
anticipate	vt.预期，预料
anticipation	n.期望，预料
antiquate	vt.使古旧，废弃
antiquated	adj.陈旧的，过时的
antique	n.古董 adj.古时的，过时的
antiquity	n.古迹；古物 n.古代 n.古老
antiseptic	n.防腐剂，杀菌剂
anxious	adj.渴望的；担忧的
apologize	vi.道歉
apology	n.道歉，歉意
appeal	n.吸引力 vi.吸引 vi.上诉，申请
appealing	adj.动人的，媚人的
appetite	n.胃口，食欲
applaud	vi.喝彩，欢呼
appliance	n.用具，器具
applicant	n.申请人
application	n.申请 n.施用，运用；作用，影响
apply	v.应用，适用 vi.申请
appoint	vt.任命，选派
appointment	n.约会 n.指定
apportion	vt.（按比例或计划）分配
appraisal	n.评价，估价
appreciable	adj.(数量或变化)很大的，值得重视的
appreciate	vt.赏识；鉴赏 vt.感激
appreciation	n.欣赏；口味，兴趣
apprentice	n.学徒
approach	n.方法 vt.接近，靠近
approaching	adj.接近的，逼近的
appropriate	adj.适当的 vt.拨款；占用
appropriation	n.拨款
approval	n.赞成，正式批准
approve	vt.批准 vi.赞成，同意
approximate	v.接近，近似 adj.大约的，估计的
approximately	adv.近似地，大约
apt	adj.恰当的，贴切的 adj.易于…的
aptly	adv.适当地，得体地
aquamarine	n.绿玉；碧绿色
aquarium	n.水族馆
aquatic	adj.水生的，水栖的
arbitrary	adj.专横的，专制的，武断的
arboreal	adj.树栖的；树的
arc	n.弧形，拱形
archaeological	adj.考古学的
archaeology	n.考古学
archipelago	n.群岛
architect	n.建筑师
architectural	adj.建筑上的；建筑学的
architecture	n.建筑；建筑学
ardent	adj.热烈投入的，极热心的
arduous	adj.费力的，艰难的
arena	n.竞技场，舞台
aria	n.独唱曲，咏叹调
arid	adj.干旱的；贫瘠的
arithmetic	n.算数
armor	n.装甲；装甲车
armored	adj.披甲的，装甲的
armory	n.纹章；兵工厂，军械库
arms	n.武器，兵种
aroma	n.香气，芬芳，芳香
aromatic	adj.芬芳的
arouse	vt.刺激，激起；唤醒
arrange	vt.计划，准备 vt.整理，摆放
arrangement	n.排列，安排
array	n.编队；大批
arsenal	n.兵工厂，军械库
arthritis	n.关节炎
article	n.论文，文章 n.物品 n.条款
articulate	vt.清楚地讲话，清晰地发音 adj.善于言辞的；表达清晰的
artificial	adj.人造的，人工的 adj.虚假的，矫揉造作的
artisan	n.手工业工人，手艺人
ascend	vt.（渐渐）上升，升高；攀登
ascending	adj.上升的，向上的
ascent	n.上升，攀登
ascribe	vt.把…归于
aspect	n.（问题等）方面；样子，外表
aspiration	n.雄心，抱负
aspiring	adj.有抱负的,有理想的,积极向上的
assault	n.（武力）袭击；（口头）攻击
assemblage	n.集合，组合
assemble	vt.集合，装配 vi.聚集
assembly	n.集会；参加集会的人们 n.装配，安装
assert	vt.声称，坚持
assess	vt.估计，分析，评估
assessment	n.估价，评估
asset	n.assets 财产，资产 n.优势；重要的品质
assignment	n.任务，作业 n.分配
assimilate	vt.学习，吸收（知识） vt.吃，吸收
assist	vt.援助，帮助
assistance	n.协助，援助
assistant	n.助手，助教 adj.辅助的，助理的
assistantship	n.研究生助教奖学金
associate	v.关联，联合 n.伙伴 adj.准的/副的（比正职低一级）
association	n.关联，联合 n.协会
assorted	adj.各式各样的，多样混合的
assortment	n.各类物品的聚集，混合物
assume	vt.假定，设想 vt.承担(责任)；采用(形式或姿势)
assumption	n.假设；就职
assure	vt.确保；向…保证，使确信
assuredly	adv.确实地，确信地
astonish	vt.使惊讶
astonished	adj.惊讶的
astonishing	adj.惊人的，奇迹的
astound	vt.使惊异
astounding	adj.令人吃惊的
astronomer	n.天文学家
astronomical	adj.天文学的
astronomy	n.天文学
astute	adj.机敏的，精明的
asymmetrical	adj.不均匀的, 不对称的
atheist	n.无神论者
athlete	n.运动员
atmosphere	n.大气，大气层；（某地的）空气
atom	n.原子
atomic	adj.原子的；微小的
atomization	n.原子化；雾化
atrophy	n.萎缩；萎缩症
attach	vt.系，缚
attached	adj.附加的，附属的
attachment	n.依恋，喜欢 n.附件，附加装置，配属
attain	vt.达到，获得
attainment	n.成就
attempt	n./vi.尝试
attend	vt.参加；入学 vt.照顾
attendance	n.出席，出席的人数
attendant	n.侍者，护理人员 adj.伴随的
attention	n.注意，重视，关心
attire	n.穿着，服饰（正规服装的总称）
attorney	n.代理人，辩护律师
attract	vt.吸引；引起注意
attraction	n.吸引；吸引人的事物
attractive	adj.吸引人的，有魅力的
attribute	n.属性，品质 vi.把…归于，归因于
audible	adj.听得见的
audience	n.观众
audit	vt.旁听；稽核，审查
audition	n.（对艺人的）面试（试演/试唱）
auditorium	n.大礼堂
auger	n.螺丝钻，钻孔机
augment	vt.增加，增大
aurora	n.极光=auroral light
authentic	adj.真的；可靠的，确实的
authenticate	vt.证明…为真
authority	n.权力，权限；权威人士 n.authorities 当局
authorize	vt.授权，批准
autobiographical	adj.自传的，自传体的
autobiography	n.自传
automated	adj.自动的
automatic	adj.自动(化)的；无意识的，机械的
automotive	adj.汽车的，自动推进的
autonomous	adj.自治的，独立的
autonomy	n.自治，自治权
auxiliary	adj.辅助的；补充的
available	adj.自由的，有空的 adj.可利用的，可得到的
avalanche	n.雪崩
avant-garde	n.先锋派(艺术流派)；先锋，前卫
avenue	n.林荫道, 大街
average	adj.一般的，通常的；平庸的 n.平均水平；平均数 vt.平均为
averse	adj.反对的，不愿意的
aversion	n.厌恶，憎恨
avert	vt.转移；避免，规避
aviation	n.航空；航空学
aviator	n.飞行员，飞行家
avid	adj.渴望的；热心的
avocation	n.(个人)副业，业余爱好
avocational	adj.副业的，嗜好的
avoid	vt.躲避，规避
avoidable	adj.可避免的
avoidance	n.避免
awareness	n.意识
awkward	adj.笨拙的，不灵活的
awkwardly	adv.(见到生人)局促不安地，笨拙地
axis	n.轴；轴心
baboon	n.狒狒
baby-sitter	n.临时保姆，代人照顾婴儿者
bachelor	n.学士（学位）；单身汉
backbone	n.骨干，支柱 n.脊椎，中枢
backdrop	n.舞台背景；背景
backpack	n.背包
baggage	n.行李
balance	n.平衡 vt.使平衡，使均衡
balanced	adj.均衡的；平稳的
bald	adj.秃头的；光秃的
ballet	n.芭蕾舞
balloon	n.气球
balloonist	n.气球驾驶者
balmy	adj.芳香的；（空气）温和的
ban	vt.禁止，查禁
band	n.乐队；队 n.（光或颜色的）带；带子 vi.联合，集合
bandanna	n.大手帕
bandleader	n.乐队指挥
bandmaster	n.乐队指挥
bang	v.发出砰的一声，重击
banker	n.银行家
bankrupt	adj.破产了的 v.（使）破产
bankruptcy	n.破产
banner	n.旗帜，标语，横幅
bar	n.酒吧 snack bar 快餐店 n.条，棒；栅 n.律师业
barb	n.（鱼钩等的）倒钩；倒刺
barbecue	n.烤肉野餐
barber	n.理发师
bare	adj.无遮蔽的，赤裸的，光（秃）的 adj.仅有的，勉强的
barely	adv.仅仅 adv.几乎不能
barge	n.驳船
bark	n.树皮 n./vi.狗叫，咆哮
barn	n.谷仓；畜棚
baroque	adj.高度装饰的，过分雕琢的
barrel	n.桶
barren	adj.贫瘠的；荒凉的
barrenness	n.荒凉
barrier	n.屏障，障碍；栅栏
barter	n./v.物品交换，易货贸易
basement	n.地下室
basin	n.盆；盆地
bead	n.珠子；（液体）小滴
beaded	adj.以珠装饰的，珠状的
beak	n.鸟喙
beam	n.木结构大梁
bean	n.豆子
bear	vt.负担，支撑 vt.具有，带有 vt.生产，生育 n.熊（polar bear 北极熊，grizzly bear 灰熊）
beard	n.胡须
beat	v.打击，敲击；打败 adj.疲倦的 n.（音乐）拍子
bedrock	n.基础；基石
behalf	n.代表…，作为…的代表
behave	vi.举止，表现
behavior	n.举止，行为
belie	vt.给人错觉；掩饰
bellows	n.风箱
below	prep./adv.在…下面
beneath	adv./prep.在…之下
beneficial	adj.有益的，有利的
benefit	n.利益，好处 vt.有益于，有助于
benign	adj.（病）良性的；亲切和蔼的
bequest	n.遗产，遗赠
besides	adv.除了…（还有）
besiege	vt.围攻；困扰
bestow	vt.给与，赐赠
betray	vt.出卖，背叛
beverage	n.（除水之外的）饮料
bias	n.偏见，偏好
bicameral	adj.两院制的，有两个议院的
bilateral	adj.有两面的, 双边的
bill	n.帐单，发票 n.（细长或扁平的）鸟嘴 n.议案，法案 n.钞票，纸币
billion	n./adj.十亿（的）
biographer	n.传记作家
biography	n.传记
biologist	n.生物学家
bison	n.美洲或欧洲的野牛
bitter	adj.苦（味）的 adj.（令人）痛苦的；尖酸刻薄的
bitterness	n.苦味；辛酸，苦难
bizarre	adj.奇异的，古怪的
blacksmith	n.铁匠
blame	vt.谴责，责备 n.过失，责备
bland	adj.淡味的；无味的
blanket	n.毯子；厚的遮盖物
blast	vi.爆破 n.一阵（风、气流或噪音）
blaze	vi.燃烧，照耀 n.火焰，光辉
blazing	adj.炽烧的；闪耀的
bleach	vt.去色，漂白
bleak	adj.荒凉的，凄凉的
blend	vt.混合，掺混 n.混合（物）
blessing	n.祝福，恩赐
blink	v.眨眼
blizzard	n.暴风雪
block	n.一块（木头或石头等） n.街区 vt.阻碍，阻止
bloom	v.（使）开花，（使）繁盛  n. 花
blossom	n./vi.花/开花
blues	n.抑郁，沮丧；布鲁斯音乐
bluff	n.悬崖，绝壁；v.诈骗，吓唬
blunt	adj.直言不讳的 adj.钝的，不锋利的，不尖的
blush	vi.脸红，羞愧
board	n.（薄而平的）木板 n.委员会 n.膳食费用 vt.上（船、飞机等）
boarder	n.寄宿者；寄生者
boardinghouse	n.寄宿公寓
boast	n./v.自夸，以有…而自豪
boastful	adj.吹嘘的，自负的
bold	adj.勇敢的，大胆的；放肆/无礼的
bolster	n.垫子，枕垫 vt.支持
bonanza	n.富矿带；幸运，带来好运的事
bond	n.联结，联系；粘连；化学键 n.公债
boom	n.繁荣 vi.急速发展
boon	n.恩惠，恩赐
boost	vt.增加，提高，促进
bore	vt.钻孔；令人厌烦
boredom	n.烦恼，无聊
boring	adj.令人厌烦的
boulder	n.巨石
bounce	v.（使）反跳，弹起
bound	adj.被束缚的；有义务的 n.范围，限制
boundary	n.分界线，边界
boundless	adj.无限的，无边无际的
bouquet	n.花束
bow	n.弓；弓形
bowl	n.碗，碗状物
bowlegged	adj.弯脚的
braid	vt.编织
brain	n.脑，大脑；头脑，智力
brawl	n.争吵
brawling	n.争吵，喧嚷
breach	vt.打破，突破 n.违背，破坏
breakup	n.分裂，分离
breath	n.呼吸，气息
breathe	v.呼吸，呼出
breathing	n.呼吸
breathless	adj.无声息的，喘不过气来的
breathtaking	adj.令人激动的；惊人的
breed	vt.养育，繁殖
breeze	n.微风
brighten	v.点亮 vt.使愉快；使乐观
brilliance	n.聪明；辉煌
brilliantly	adv.辉煌地，灿烂地
brim	n.边；边缘
briny	adj.盐水的，咸的
brisk	adj.活泼的，轻快的
briskness	n.敏捷，活泼
brittle	adj.易碎的
broad-brimmed	adj.宽边的
broadcast	n./vt.广播；传播
broaden	v.放宽，变宽，扩大
brochure	n.小册子
bronze	n.青铜；铜像
brook	n.小河
brown	n./adj.褐色（的），棕色（的） vt.（使）成褐色，晒黑
brownish	adj.成褐色的
bubble	n.气泡，水泡
buckle	n.皮带扣环 v.扣紧；（使）变弯曲
bud	n.芽，蓓蕾 vi.发芽
buddy	n.密友，伙伴
budget	n.预算
buggy	n.小马车，童车
bulb	n.电灯泡；球茎
bulk	n.大批；大部分 n.大小，体积
bulky	adj.庞大的，笨重的
bump	n.肿块；突起 v.碰（伤），撞（破）
bunch	n.串，束；群 vi.捆成一束；聚集
bundle	n.捆，束，包 vt.捆
burdensome	adj.繁重的，劳累的
burgeon	vi.迅速成长，发展
burning	n./adj.燃烧（的） adj.强烈的
burrow	n.洞穴 vi.挖地洞
bush	n.矮树丛
bust	n.半身像，半身雕像
bustle	n.喧闹，匆匆忙忙
butter	n.黄油，牛油
butterfly	n.[动]蝴蝶
buzz	n./v.嗡嗡声；发出嗡嗡声
buzzer	n.蜂鸣器
by-product	n.副产品
cab	n.出租马车、汽车
cabin	n.小屋；船舱
cabinetmaker	n.家具师，细木工匠
cacti	n.（pl）仙人掌-单数cactus
cadence	n.（语调的）抑扬顿挫
calculate	vt.计算；估计
calculation	n.计算，考虑
calculator	n.计算器
calibration	n.校准；标度，刻度
calm	adj.（天气、海洋等）静的，平静的 adj.镇静的，沉着的 vt.使平静，使镇定，平息
camouflage	n./v.伪装
campaign	n.(政治或商业性)活动，竞选活动
cancel	vt.取消
cancellation	n.取消
candid	adj.率直的，坦白的
candidate	n.候选人
cannibalism	n.同类相食
canopy	n.天篷，遮篷
canvas	n.帆布；画布
canyon	n.峡谷
capability	n.能力
capable	adj.有能力的
capacity	n.容量；能力
capillary	n.毛细管
captivity	n.囚禁，拘留
carapace	n.（蟹或龟的）甲壳
carat	n.（宝石重量单位）克拉
carbohydrate	n.碳水化合物
cardiac	adj.心脏的
cardinal	adj.首要的，主要的 n.一种美洲鸟，雄性有深红色羽毛
career	n.生涯，职业
careerism	n.野心，追求名利
careful	adj.小心的，仔细地
careless	adj.粗心的，疏忽的
carelessly	adv.不注意地，粗心地
cargo	n.货物
caricature	n.讽刺画
carnival	n.狂欢节
carnivorous	adj.食肉的
carve	vt.切开；雕刻
carver	n.雕刻匠，雕工
carving	n.雕刻品，雕花
cassette	n.盒式磁带
cast	vt.浇铸 vt.投，抛
cast-iron	adj.铸铁的
casting	n.铸件，铸造
casual	adj.非正式的，随便的；漫不经心的
catalyst	n.催化剂；促使事情发展的因素
catalyze	vt.促使；激励
catastrophe	n.异常的灾祸
catching	adj.传染的；有魅力的，迷人的
categorize	vt.分类
category	n.种类，类目；范畴
cater	vi.满足需要，迎合
caterpillar	n.毛虫
cathedral	n.总教堂，大教堂
cause	vt.导致，引起 n.原因；事业
caution	n.小心，谨慎 vt.警告
cautious	adj.小心的，谨慎的
cautiously	adv.小心地，谨慎地
cavern	n.大山洞，大洞穴
cavity	n.洞；腔
cease	v.停止，终止
ceaseless	adj.不停的
celebrate	vt.庆祝，祝贺；表扬，赞美
celebrated	adj.有名的，大名鼎鼎的
celebrity	n.名人
celestial	adj.天体的；天上的
cell	n.细胞，单人牢房，电池
cellist	n.大提琴家
cello	n.大提琴
census	n.人口调查，人口普查
centennial	n.百年纪念
centigrade	adj.摄氏（温度）的
ceremonial	n.仪式 adj.正式的；仪式的
ceremony	n.典礼，仪式；礼节
chafe	vt.（将皮肤等）擦热，擦破 vt.使恼火
chagrin	n.懊恼，失望
chalk	n.粉笔
chamber	n.室；房间
champion	n.冠军；拥护者 vt.支持；主张
championship	n.锦标赛
chaos	n.混乱
chaotic	adj.混乱的
chapel	n.小礼拜堂
character	n.角色；性格
characteristic	adj.典型的，表现特征的，特有的 n.特征，特性
characterize	vt.表现…的特色，刻画…的性格
charcoal	n.炭；木炭
charitable	adj.慈善事业的，慈善的；仁慈的
chart	n.海图，图表 vt.制图
charter	v.包租；特许 n.宪章，章程
chaste	adj.贞洁的，朴素的
chat	vi.闲谈
chateau	n.城堡，高级旅馆
check	vt.检查，核对；阻止，控制 n.支票
checkout	n.检验，校验
checkup	n.审查；身体检查
chef	n.厨师
cherish	v.怀抱（希望等）；珍爱
chill	vt.使冷，变冷；冷却 n.寒意，寒战
chilli	n.红辣椒
chilly	adj.寒冷的
chimpanzee	n.黑猩猩
chisel	n.凿子 v.砍凿，凿刻
chivalry	n.骑士气概，侠义；（男人）对女人彬彬有礼，献殷勤
choke	vt.使窒息
chop	vt.砍
choppy	adj.波浪起伏的,(风)不断改变方向的
chord	n.琴弦，心弦
chore	n.家务杂事
choreograph	vt.设计舞蹈动作
choreographer	n.舞蹈指导
choreographic	adj.舞蹈术的，舞台舞蹈的
choreography	n.舞蹈编排
chorus	n.合唱团
chromosphere	n.色球
chronic	adj.长期的；慢性的
chronological	adj.按年代顺序排列的
chronology	n.年代学，年表
chubby	adj.丰满的，圆胖的
chunk	n.大块
cider	n.苹果酒，苹果汁
cipher	n.密码
circle	n.圆周，圆形物 n.（具有共同兴趣、利益的人组成的）圈子，集团 vt.包围，环绕
circuit	n.电路
circular	adj.循环的；圆的
circulate	v.（使）循环；（使）传播
circulation	n.循环；流通
circumference	n.圆周；周长
circumscribe	vt.划界限；限制
circumstance	n.环境，情况
citadel	n.堡垒，要塞
cite	vt.引用，举例
citizenship	n.公民（的身份）
civil	adj.公民的；市民的 adj.国内的
civilian	adj.平民的；民用的 n.平民
civility	n.彬彬有礼，斯文
civilization	n.文明，文化
claim	n.要求，要求权 v.声称，主张
clam	n.蛤，蛤肉
clamor	n.叫嚣，喧哗
clan	n.家族，宗族
clap	n.拍手声；霹雳声 v.鼓掌；轻拍
clarification	n.澄清，净化
clarify	vt.澄清，阐明
classification	n.分类，分级
classify	vt.把…分类，分等级
clause	n.分句；条款
clay	n.粘土；泥土
clergy	n.牧师
clergyman	n.牧师，教士
cliff	n.悬崖峭壁
climate	n.气候；社会风气或趋势
climatic	adj.气候上的
cling	vi.粘紧，附着 vi.坚持（意见），墨守（习惯）
clinic	n.门诊所
clinical	adj.临床的
clip	vt.修剪
clockwise	adj./adv.顺时针方向的（地）
clog	vt.障碍，阻塞
clumsy	adj.笨拙的；愚笨的
cluster	n.簇，串，群 vi.丛生；聚集
clutch	v.抓住，攫取 n.一次产的或孵的蛋（或卵）
coach	n.教练 n.四轮大马车
coalesce	vi.联合，合并
coalescence	n.合并，联合
coalition	n.联合，同盟
coarse	adj.粗糙的
coax	vt.哄诱，巧言诱哄
codify	vt.编成法典，编辑成书
coexist	vi.同时存在，共存
coffeepot	n.咖啡壶
cognitive	adj.认知的；感知的
coherence	n.一致
coherent	adj.粘在一起的 adj.连贯的；有条理的
cohesion	n.附着（力），凝聚力
cohesive	adj.粘着的
coil	n.（一）卷；线圈 vt.盘绕，卷
coin	n.铸币 vt.创造（一个新的词语或短语）
coinage	n.造币，货币制度
coincide	vi.同时发生；相符合，相巧合
coincidence	n.一致；同时发生或同时存在的事
coincident	adj.一致的，符合的；巧合的
collaborate	vi.协作，合作
collaboration	n.合作
collapse	n.倒塌；崩溃，失败
colleague	n.同事，同僚
collective	adj.集体的，共同的
collide	vi.碰撞；冲突
collision	n.碰撞；冲突，抵触
colloquial	adj.口语的，通俗语的
colloquialism	n.俗话，白话，口语
colonel	n.陆军上校
colonial	adj.殖民的，殖民地的
colonize	vt.建立殖民地，拓殖 vt.定居，居于
colony	n.殖民地；群体
colossal	adj.巨大的
combination	n.化和，组合
combine	v.联合，结合
combustible	adj.易燃的
combustion	n.燃烧
comet	n.彗星
cometary	adj.彗星的，彗星似的
comic	adj.滑稽的，好笑的；喜剧的
comical	adj.滑稽的，好笑的
commander	n.司令官，指挥员
commemorate	v.纪念
comment	n.注释，评论 vi.谈及；注释，评论
commentary	n.注释，解说词
commentator	n.评论员，讲解员
commerce	n.商业
commercial	adj.商业的，贸易的
commercialize	vt.使商业化，使商品化
commission	vt.委任，任命；委托，委托制作 n.佣金
commissioner	n.委员，专员
commit	vt.犯（错误），干（坏事）
commitment	n.信奉，支持；许诺，承担义务
committed	adj.效忠的；忠于…的
committee	n.委员会
commodity	n.商品，日用品
commonplace	adj.平凡的
commonsense	adj.具有常识的
communal	adj.公共的；公社的
communicate	vt.传达，沟通；通信
communication	n.沟通；通讯
community	n.团体，社会；(生物)群落
commute	v.通勤
commuter	n.经常往返者
compact	adj.紧凑的，紧密的；简洁的 vt.压缩；使密集
compaction	n.压紧
companion	n.同伴，同事
comparable	adj.可比的，比得上的；类似的
comparative	adj.比较的
comparatively	adv.相当地；比较地
compatible	adj.可以并存的，相容的，协调的
compel	vt.强迫，使不得不
compensate	vt.补偿，赔偿
compensation	n.补偿，赔偿
compensatory	adj.补偿性的
compete	vi.竞争，比得上
competence	n.能力，胜任
competent	adj.有能力的，能胜任的
competing	adj.有竞争性的，不相上下的
competition	n.竞争，竞赛
competitiveness	n.竞争能力
compile	vt.汇集，编辑
complacence	n.自满，自以为是
complain	v.抱怨；悲叹
complaint	n.抱怨，怨言
complement	vt.补充，使完善 n.补足物，补充物
complementary	adj.补充的，补足的
complex	adj.复杂的，费解的；结构复杂的 n.综合体
complexity	n.复杂（性）
complicated	adj.费解的，棘手的；结构复杂的
complication	n.并发症；复杂，复杂性
complicity	n.共谋；同谋，共犯
compliment	n.恭维，称赞
complimentary	adj.赞美的
component	n.成分，组成部分
compose	vt.作曲，写作；组成
composition	n.构成，组成 n.写作，作文；作曲
compound	n.化合物
comprehend	vt.领悟，理解
comprehensible	adj.可理解的，易于了解的
comprehension	n.理解，包含
comprehensive	adj.全面的，综合的
compress	vt.压缩，浓缩
compressed	adj.被压缩的，紧凑的
compression	n.浓缩，压缩
comprise	vt.包含；由…组成
compromise	n./v.妥协，折衷
compulsory	adj.必须做的，被强制的
computation	n.计算，估计
compute	vt.计算
concave	adj.凹的
conceal	vt.隐藏，隐瞒
concede	v.承认
conceive	vt.构思；设想
concentric	adj.同心的
concept	n.概念，观念
conception	n.观念，概念
conceptual	adj.概念上的
concert	n.音乐会 n.一致；共同
concerted	adj.商议好的，协定的
concerto	n.协奏曲
concise	adj.简洁的，简明的
conciseness	n.简洁，简短
conclude	v.推断；作出结论 vi.结束
conclusive	adj.最后的，决定性的
concomitant	adj.伴随的         n. 伴随物
concrete	n.水泥 adj.具体的，实体的
concurrent	adj.并发的；协作的，一致的
condemn	vt.谴责
condemnation	n.谴责
condensation	n.压缩，浓缩
condense	vt.使浓缩；精简
condenser	n.冷凝器；电容器
condiment	n.调味品
condition	n.条件；状况；健康状况
conditioning	n.（心理）条件作用，训练
condor	n.秃鹰
conduct	vt.做（试验、研究等）；引导，带领 vt.传导 n.举止，行为
conductivity	n.导电率；传导率
conductor	n.导体
cone	n.圆锥，松果
confederacy	n.联盟
confederate	n.同盟者，盟友
confer	v.颁给，赋予 v.协商
conference	n.会议；协商会，讨论会
confess	vt.坦白承认
confession	n.承认，招供
confide	vt.吐露（心事），倾诉
confidence	n.信心
confident	adj.有信心的，自信的
configuration	n.轮廓，构型
confine	vt.限制
confinement	n.限制，禁闭
confining	adj.狭窄的
confirm	vt.证实，使…更坚定
confirmation	n.确认，证实
conflict	n.争论，冲突，斗争
conflicting	adj.相冲突的，相矛盾的
confluence	n.汇合；聚集
conform	vi.遵守，顺从；符合
conformity	n.一致，符合
confront	vt.面对，正视
confuse	vt.搞乱，使糊涂
confuse…with…	把…认为
confusion	n.混乱，混淆
congenial	adj.趣味相投的，适意的
congenital	adj.先天的，天生的
congested	adj.堵塞的；拥挤的
congestion	n.拥挤，拥塞
conglomerate	n.混合
congratulation	n.祝贺，道喜
congregate	v.聚集
congress	n.国会，议会
congressional	adj.会议的，大会的；国会的
congressman	n.国会议员
conifer	n.松类，针叶树
conjectural	adj.推测的
conjecture	n./v.推测，猜测
connect	v.连接；联系；联合
connection	n.连接
connoisseur	n.鉴赏家，行家
conscience	n.良心，良知
conscientious	adj.尽责的，一丝不苟的
conscious	adj.有意识的，神志清醒的 adj.意识到的
consciously	adv.有意识地，自觉地
consciousness	n.意识，知觉
consecutive	adj.连续的
consequence	n.结果
consequent	adj.作为结果的，随之发生的
consequently	adv.从而，因此
conservation	n.保存，保持
conservationist	n.（天然资源的）保护管理论者
conservatism	n.保守主义，守旧性
conservative	adj.保守的，谨慎的；守旧的
conserve	vt.保存,保藏   n.可长期保存的食物
considerable	adj.相当大（多）的；值得考虑的；相当可观的
considerably	adv.相当地
considerate	adj.考虑周到的，体贴的
consideration	n.体谅，考虑
consistency	n.浓度，密度
consistent	adj.一致的；稳定的，变化少的
consistently	adv.一贯地
consonant	adj.协调一致的
consort	vi.陪伴，结交
consortium	n.协会，联盟，财团
conspicuous	adj.显著的；显眼的，引人注目的
conspiracy	n.阴谋，共谋
constant	adj.不变的，持续的；一再重复的
constantly	adv.不断地
constellation	n.星座 n.灿烂的一群
consternation	n.惊愕，惊慌失措
constituent	n.成分，要素 n.选民
constitute	vt.建立（政府），组成，构成
constitution	n.组织；宪法
constitutional	adj.宪法的；章程的
constrain	vt.抑制，拘束
constraint	n.约束，强制
constrict	vt.约束；收缩
constricted	adj.抑制的，约束的
construct	vt.建造；创立
construction	n.建筑，建造
consult	vt.咨询，请教
consultant	n.顾问，咨询者
consume	vt.消费，消耗；大吃大喝
consumer	n.消费者
consumption	n.消耗，消费
contact	vt.使接触，与…联系
contagious	adj.传染性的；有感染力的
contain	vt.包含，容纳
container	n.容器；集装箱
contaminate	vt.弄脏，污染；感染
contamination	n.玷污，污染
contemplate	v.沉思，对…作周密思考
contemporary	adj.当代的，同时代的
contender	n.竞争者，斗争者
content	n.内容；容量 adj.满足的
contented	adj.满足的，心安的
contention	n.争论，争辩
context	n.上下文，语境
contiguous	adj.接近的，接壤的
continent	n.大陆
continental	adj.大陆的，大陆性的
continuation	n.继续，延长
continuity	n.(时间或空间的)连续性，连贯性
continuum	n.连续统一体
contour	n.contours 轮廓 n.周线，等高线
contract	v.收缩 v.定契约，立合同 n.契约，合同
contraction	n.缩短，收缩
contractor	n.定约人，承包人
contradict	vt.同…矛盾，同…抵触
contradictory	adj.反对的，矛盾的
contrary	adj.相反的；对抗的
contrast	n.（对比，对照的）差异 vt.对比，对照
controversial	adj.引起或可能引起争论的
controversy	n.争论，辩论
convenience	n.便利，方便
convenient	adj.方便的；近便的，容易到达的
convention	n.会议；传统
conventional	adj.传统的，习俗的
conventionally	adv.按照惯例地，照常套地
converge	vi.聚合，集中于一点，会聚
conversant	adj.亲切的，熟悉的
conversation	n.会话，非正式会谈
conversational	adj.对话的，会话的
converse	v.谈话，交谈
conversion	n.变换，转化
convert	vt.转换；转变信仰
converter	n.炼钢转炉
convex	adj.凸出的
convict	vt.证明…有罪，宣告…有罪
conviction	n.确信，深信，坚信
convinced	adj.确信的，深信的
convincing	adj.令人信服的
convivial	adj.欢乐的，快乐的
cooperate	vi.合作
cooperation	n.合作，协作
cooperative	adj.合作的，协力的
coordinate	vt.使…协调，相配合
coordinated	adj.协调的，配合的
coordination	n.调和
copper	n.铜
core	n.中心，核心；地核
corn	n.玉米，谷类
cornet	n.短号
corps	n.军团，兵团
correlate	vt.使相互关联；使相互影响
correlated	adj.有相互关系的
correspond	vi.符合，协调；通信
correspondence	n.通信，信件 n.相应，对应
corresponding	adj.相应的
corrosion	n.腐蚀，侵蚀
corrosive	adj.腐蚀的，腐蚀性的
corruption	n.腐败，贪污，堕落
cosmic	adj.宇宙的
cosmopolitan	adj.世界性的，全球的
costume	n.服装 vt.穿上服装；穿衣
cottonwood	n.[植]三叶杨,棉白杨
counsel	n./vt.劝告
counseling	n.咨询服务
counselor	n.顾问，法律顾问
counteract	vt.消除，抵消
counterbalance	v.使平衡
counterclockwise	adj./adv.逆时针的（地）
counterfeit	vt.伪造，仿造 adj.伪造的，假冒的
counterpart	n.相似的人或物，配对物
countless	adj.无数的
couple	n.（一）对，（一）双；夫妇 vi.连合，结合
courier	n.送急件的人，信使
court	n.法庭；球场 vt.向…献殷勤，追求；设法获得（他人的支持等）
courteously	adv.有礼貌地，亲切地
courthouse	n.法院；郡政府所在地
courtly	adj.尊严而有礼貌的
courtship	n.求爱；求爱时期
cover	vt.覆盖；包括；报道
coverage	n.覆盖
cowboy	n.牛仔
cowhand	n.牛仔，牧牛工
cozy	adj.舒适的，惬意的
crab	n.蟹
crack	n.裂缝，裂纹；缺点 v.（使）爆裂；裂开
craft	n.工艺，手艺
craftspeople	n.手工艺人
cram	v.填塞；匆忙准备
cramped	adj.狭窄的
crash	n./vt.碰撞，坠毁，撞碎 n.破产，垮台
crater	n.火山口；弹坑
crawl	vi.爬，爬行
crayon	n.蜡笔、彩笔及其绘画
craze	n.狂热
crazy	adj.疯狂的，狂热的
credence	n.信任，相信
credentials	n.凭据，文凭
credit	n.学分 n.信誉，信用；荣誉，声望 n.贷方，银行存款 vt.认定… ；把…归给，归于
creditor	n.债权人
creek	n.小溪，小河
creep	vi.慢慢行进；爬行
crevice	n.缺口，裂缝
crew	n.全体工作人员；同事们
crimson	n./adj.深红色（的）
cripple	vt.削弱；使残废
crippling	adj.令人震惊的
crisscross	vi.交叉往来
critical	adj.评论的，批评的 adj.危急的；非常重要的
critique	n.（文艺）批评，评论
crooked	adj.不诚实的；欺诈的 adj.弯曲的；蜿蜒的
crossbones	n.十字骨头
crossbreeding	n.（生物）杂种
crosscut	adj.横切的
crossing	n.横越，交叉口
crow	n.乌鸦
crude	adj.粗糙的，粗鲁的；原始的
crumble	v.粉碎；崩溃
crumple	vt.把…弄皱；起皱
crush	vt.压垮；粉碎；使变形
crust	n.硬外皮；地壳
crustacean	n.甲壳动物
crystal	n.水晶，晶体 adj.清澈的；结晶状的
crystalline	adj.水晶的，透明的
crystallization	n.结晶化
crystallize	v.明确；使结晶化
crystallized	adj.变成晶体的
cube	n.立方体，立方
cubic	adj.立方体的
cubism	n.立体主义
cucumber	n.黄瓜
cue	n.提示，暗示
culinary	adj.厨房的，烹调的
culminate	v.达到高潮/顶点
cultivate	vt.耕种；培养
cultivation	n.耕种；培养
culture	n.文明，文化 vt.培养（微生物细胞组织等）
cumbersome	adj.笨重的，难处理的
cupboard	n.食橱，碗碟柜
curator	n.（博物馆等）馆长
curiosity	n.好奇心
curious	adj.（令人）好奇的
currency	n.通货，货币
current	n.（液体、气体）流，趋势 adj.现今的
currently	adv.现在，当前
curriculum	n.学校的全部课程
cushion	n.垫子，软垫 v.缓和…的冲力，保护
custodian	n.看守人，管理人
custom	n.习惯，传统，惯例
customarily	adv.通常
customer	n.消费者
customs	n.进口税；海关
cuticle	n.表皮
cyclone	n.旋风，龙卷风
cylinder	n.圆筒，圆柱体
dagger	n.短剑，匕首
daisy	n.雏菊
damp	adj.潮湿的，有湿气的
dampen	vt.使潮湿
dangerous	adj.危险的
daring	adj.大胆的，勇敢的
dart	v.飞奔；投掷 n.标枪，镖，箭
date	vt.注明…的日期
dated	adj.陈旧的，过时的
daunting	adj.使人畏缩的
dawn	n.黎明；开端，开始
dawning	n.拂晓，黎明
dazzling	adj.眼花缭乱的；耀眼的
deadly	adj.致命的；极度的
deal	n.交易；份量
debatable	adj.未决定的，有争执的
debate	n.争论，辩论
debris	n.废墟，残骸；碎片
debt	n.债务
debtor	n.债务人
decadent	adj.颓废的
decay	vi./n.腐烂 vi./n.衰落
deceive	vt.欺骗，行骗
decent	adj.适当的，可接受的 adj.得体的，体面地
deception	n.欺骗，诡计
deceptive	adj.欺骗的，导致误解的
deciduous	adj.每年落叶的
decimal	adj.十进制的，小数的 n.小数
deck	n.一副（纸牌）
declaration	n.宣布，宣言
declare	vt.宣布，声明
decline	vi./n.衰退；下降，减退 vt.婉言谢绝
decompose	v.分解，（使）腐烂
decomposition	n.腐烂，分解
decorate	vt.装饰，装潢，修饰
decoration	n.装饰，装饰品
decorative	adj.装饰的，可作装饰的
decrease	v.减少
defecate	vi.排粪；通大便
defect	n.缺点，瑕疵
defective	adj.有缺陷的
defend	vt.防护；辩护
defense	n.防卫；防卫物
defensive	adj.自卫的
defer	vi.遵从，听从 vt.延期
deference	n.尊重，顺从；敬意
deferential	adj.恭敬的, 恭顺的
deficiency	n.缺乏；不足
deficient	adj.缺乏的，不足的
deficit	n.赤字，不足额
definite	adj.清楚的；明确的；确切的
definitely	adv.明确地，肯定地
definition	n.定义
definitive	adj.决定性的，最后的
deform	vt.使变形
deformation	n.变形
defrost	vt.解冻，将…除霜
deft	adj.灵巧的，熟练的
degradation	n.退化；降级，降格
degrade	v.使降级，贬低
dehydrate	vt.使脱水
dehydrated	adj.干燥的，脱水的
dehydration	n.脱水，干燥
deign	vi.屈尊
deity	n.神，被奉若神明的人或物
delay	vt./n.推迟，耽搁
delectable	adj.美味的
delegate	n.代表 vt.委派，授权
deliberate	adj.深思熟虑的；故意的
deliberately	adv.故意地
delicate	adj.脆的，易损的；娇弱的 adj.精致的，细腻的
delicious	adj.美味的，可口的
delirium	n.精神错乱，发狂
delta	n.三角洲
demagnetize	vt.消磁，使退磁
demobilize	vt.复员
democracy	n.民主政治，民主主义
demolish	vt.破坏，摧毁
demolition	n.破坏，拆除
demonstrate	vt.演示；论证
demonstration	n.实证；示范
denomination	n.宗派，教派 n.（货币）面额
denote	vt.指示，表示
denounce	vt.公然抨击，谴责
dense	adj.密集的，浓厚的
density	n.密度
dent	n.缺口，凹痕 v.使凹下，凹进
dental	adj.牙齿的
dentist	n.牙科医生
dentistry	n.牙科
deny	vt.否认，否定 vt.剥夺，拒绝…的要求
deodorizer	n.除臭剂
depart	vi.离开，出发
departure	n.离开，出发
dependable	adj.可靠的，可信赖的
dependence	n.依赖，信赖
dependent	adj.依赖的；从属的，由…而定的 n.依赖他人者
depict	vt.描绘；描写，描述
deplete	vt.耗尽，使衰竭
deposit	vt.堆积，沉淀 vt.放置，寄存 vt.产卵 n.堆积物，沉淀；存款，押金
depositor	n.存款人
depot	n.货站，仓库
depreciation	n.贬值
depredation	n.掠夺，破坏
depress	vt.压下，压低
depressed	adj.沮丧的
depression	n.不景气，萧条期 n.凹陷处，坑 n.沮丧，消沉
deprivation	n.缺乏；剥夺
deprive	vt.剥夺，使失去
derivative	n.派生的事物；派生词
derive	vt.得到，获取；源于
desalination	n.脱盐作用
descend	v.传下，遗传 v.下降
descendant	n.子孙，后裔
descent	n.降下，降落；世系，血统
desert	n.沙漠 vt.遗弃
deserted	adj.荒芜的，荒废的
deserve	vt.应得
designate	vt.指定，任命
desirable	adj.令人向往的；令人满意的
desire	n.欲望，要求 vt.想要
desolate	adj.荒凉的，无人烟的
desperate	adj.绝望的，不顾一切的，拼死的
desperately	adv.迫切地；危急地
despoil	v.夺取，掠夺
despoiler	n.掠夺者
dessert	n.餐后甜点
destination	n.目的地
destine	vt.命运注定，预定
destruction	n.破坏；毁灭
destructive	adj.破坏的；毁灭性的
detect	vt.察觉，发觉；探测，侦查
detectable	adj.可发觉的；可查明的
detective	n.侦探 adj.侦探的
deter	vt.阻碍，制止，使踌躇
detergent	n.清洁剂
deteriorate	v.使恶化；质量下降
determinant	n.决定因素
deterrent	n.制止物，威慑力量
detest	vt.深恶，憎恶
detriment	n.伤害，危害
detrimental	adj.有害的
devastate	vt.毁坏
devastating	adj.破坏性的
devastation	n.毁坏
device	n.器械，装置
devise	vt.设计；发明
devoid	adj.全无的，缺乏的
devote	vt.投入于，献身
devotion	n.热爱，忠诚
devour	vt.贪婪地吃，吞食
diagnose	vt.诊断
diagonal	n./adj.对角线（的）
diagonally	adv.成对角线地，斜对地
diagram	n.图表
dialect	n.方言，土话
dialogue	n.对话
diameter	n.直径
dictate	vt.规定；决定，确定
diction	n.措辞，用语
diet	n.饮食，食物 vi.节食，忌食
dietary	adj.饮食的
dieter	n.节食者，减肥者
dietetics	n.营养学
dietitian	n.营养学家
differentiate	v.区分，区别
diffuse	v.扩散；散播 adj.散开的，弥漫的
diffusion	n.扩散，传播
digest	vt.消化
digestion	n.消化
digestive	adj.消化的，助消化的
dignity	n.尊严，高贵
digression	n.离题，扯到枝节上
dilate	vt.使膨胀，使扩大
dilemma	n.困境，进退两难
diligent	adj.勤勉的，勤奋的
diligently	adv.勤勉地，尽职地，小心翼翼地
dilute	vt.稀释，淡化
dilution	n.稀释，淡化
dim	adj.暗淡的，模糊的
dime	n.一角硬币
dimension	n.尺寸；尺度
dimensional	adj.空间的
diminish	v.（使）减少，（使）变小
dimly	adv.朦胧地，模糊地
dinosaur	n.恐龙
dioxide	n.二氧化物
diplomacy	n.外交，交际手腕
diplomatic	adj.外交的；老练的
disadvantage	n.缺点，坏处，不利
disagreeable	adj.不令人喜欢的，令人厌恶的
disappointment	n.失望
disapproval	n.不赞成
disaster	n.灾难，不幸；彻底的失败
disastrous	adj.损失惨重的；悲伤的
discard	vt.丢弃
discern	vt.看出；察觉到
discernible	adj.可识别的=discernable
discerning	adj.有识别能力的；眼光敏锐的
discharge	vt.释放；排出 n.流出 n.放电
disciple	n.门徒，弟子
discipline	n.纪律，训练 n.学科 vt.训练；惩罚
disciplined	adj.遵守纪律的
discomfort	n.不适
disconnect	vt.分离，断开
discontent	n.不满
discontented	adj.不满意，不满足
discount	n.折扣 vt.不全信，对…持怀疑态度
discourage	v.使气馁；阻碍
discouraging	adj.令人气馁的
discourse	n.讲道，演讲
discreet	adj.小心的，谨慎的
discrete	adj.独立的；不连续的，离散的
disgrace	vt.玷污
disgust	n.厌恶，嫌恶
disgusted	adj.厌烦的；厌恶的
disillusion	v.使醒悟
disintegrate	v.（使）分解，（使）碎裂
disinterested	adj.无个人利害关系的;无私的,公平的
dismal	adj.暗的，凄凉的；忧郁的，沮丧的
dismay	vt.使惊慌；使沮丧 n.沮丧，惊慌
dismember	vt.肢解，分割
dismembered	adj.肢解的
dismiss	vt.解散；摒除（思想、感情等）
disorganize	vt.扰乱，使混乱
dispatch	vt.分派，派遣
dispense	vt.分配，分发
dispersal	n.疏散，散开
disperse	vt.分散，散开
displace	vt.移置，转移；取代，替代
displacement	n.移置，转移
display	vt.陈列；显示 n.陈列，展览；显示
disposal	n.垃圾倾倒；处置
disposed	adj.有…倾向的
disposition	n.性情；倾向
disproportionate	adj.不成比例的
dispute	n.争论，纠纷 v.争论，争执
disregard	n./v.不理会；漠视
disrepute	n.坏名声，不光彩
disrespect	n.失礼，无礼
disrupt	vt.使混乱，使中断
disseminate	vt.传播，宣传
dissenter	n.不同意者，反对者
dissenting	adj.不同意的
dissertation	n.论文
dissimilar	adj.不同的, 相异的
dissipate	vi.消失；消散
dissipated	adj.沉迷于酒色的, 浪荡的
dissolve	vt.使溶解
distance	n.距离；远处
distant	adj.远离的，遥远的
distasteful	adj.（令人）不愉快的，讨厌的
distend	vt./vi.（使）扩大，（使）扩张
distent	adj.膨胀的，扩张的
distill	vt.蒸馏，提取
distinct	adj.明确的，确实的；不同的
distinction	n.差别，特性 n.显赫，声望
distinctive	adj.有特色的，出众的
distinctively	adv.特殊地，区别地
distinctly	adv.清楚地，显然
distinguish	vt.区别，辨认
distinguished	adj.卓著的
distort	vt.弄歪（形状等）；歪曲
distortion	n.扭曲；歪曲
distract	vt.使…分心，分散注意力
distress	n.悲痛，不幸，穷困
distribute	vt.分配；分发，散布
distribution	n.分发，分配
district	n.区域，地区
disturb	vt.打扰，扰乱
disturbance	n.骚动，动乱
dive	vi.潜水；跳水
diver	n.潜水者，跳水运动员
divergence	n.分歧，岔开
divergent	adj.有分歧的，有差异的
diverse	adj.不同的，变化多的
diversification	n.多样化
diversified	adj.多样化的
diversify	vt.使多样化
diversion	n.消遣，娱乐 n.转移，转换
diversity	n.差异，多样
divert	vt.转移，（使）转向
divide	vt.划分，分开；分裂
division	n.分开，分割
divorce	vt.离婚 vt.使分离，使脱离
dizziness	n.头昏眼花，眩晕
dizzy	adj.眩晕的
dizzying	adj.令人昏乱的；灿烂的
doctrine	n.教义，教旨
document	vt.证明；文件记录
documentary	adj.文件的  n. 纪录片
documentation	n.文件
dogged	adj.顽强的，顽固的
dogma	n.教条，教义
doll	n.洋娃娃，玩偶
dolphin	n.海豚
domain	n.领域，范围
domestic	adj.家里的；家养的 adj.本国的，国内的
domesticate	vt.驯养，驯化
domesticated	adj.驯养的，家养的
dominant	adj.支配的，占优势的
dominate	vt.统治，支配，控制 vi.盛行
donate	vt.捐赠
donation	n.捐赠，捐款
donor	n.捐助者
dormant	adj.静止的，休眠的
dormitory	n.宿舍
dorsal	adj.背部的，背脊的
dot	vt.星罗棋布于 n.点，圆点
doubt	n./vt.怀疑
doubtful	adj.可疑的；疑心的
downtown	adv./adj.在市区（的），往市区（的）
draft	n.草图，草稿 vt.起草
drag	vt.拖动
dragonfly	n.蜻蜓
drain	v.（使）流走，（使）排光 n.排水；消耗
drainage	n.排水，排出物
drama	n.戏剧
dramatic	adj.戏剧性的；引人注目的
dramatically	adv.戏剧性地；引人注目地
dramatize	vt.改编成戏剧，编写剧本
drastic	adj.猛烈的
draw	vt.吸引
drawback	n.弊端，缺点
drawer	n.抽屉
drawing	n.图画，制图
dread	n.畏惧，恐怖
dreadful	adj.可怕的
dreadfully	adv.可怕地
dreary	adj.沉闷的，阴郁的
drift	n.冲洗，漂流物   v.  （使）漂流
driftwood	n.流木，浮木
drill	vt.钻孔，打眼 n./vi.训练，操练；反复练习
drip	n.水滴；  v. （使）滴下
dripstone	n.滴水石；滤石
drought	n.干旱
drowsy	adj.昏昏欲睡的
drudgery	n.苦工，苦差事
ductile	adj.易延展的；柔软的
due	adj.预定的；到期的
dues	n.应付款
dull	adj.钝的；感觉或理解迟钝的
dumb	adj.哑的
dumbbell-like	adj.哑铃状的
dump	vt.倾泻，倾倒
duplicate	vt.复写，复制 adj.两重的，两倍的；完全相同的
durable	adj.持久的；耐用的
duration	n.持续时间
dwarf	n.侏儒  vt.把…显得矮小
dwell	vi.居住，生活于
dweller	n.居住者，居民
dwelling	n.住处，寓所
dye	n.颜料，燃料 vt.染色
dynamic	adj.动力的；动态的
dynamics	n.动力学
eager	adj.渴望的；热心的
earthenware	n.土器，陶器
earthquake	n.地震
eccentric	adj./n.古怪的（人），异常的（人）
eccentricity	n.反常，怪癖
eclecticism	n.折衷主义
eclipse	n.日蚀，月蚀 vt.盖过，使失色；遮蔽
ecological	adj.生态的；生态学的
ecologist	n.生态学者
economical	adj.经济的，节俭的
economics	n.经济学
economize	vi.节约，节省
ecosystem	n.生态系统
edentate	n.贫齿类动物
edge	n.边缘
edible	adj.可食用的
edifice	n.宏伟的建筑物
educable	adj.可教育的，可培养的
educated	adj.受过教育的，有教养的
education	n.教育，培养
effective	adj.有效的；生效的
effectiveness	n.效力
efficiency	n.效率，功效
efficient	adj.生效的；能干的，有效率的
effluent	n.流出物
eggshell	n.蛋壳
eject	vt.喷出，喷射 vt.逐出，驱逐
elaborate	adj.精细的，精心的；详尽的 vt.详细阐述
elaborately	adv.精细地，详尽地
elasticity	n.弹力，弹性
elbow	n.肘
election	n.选举；当选
electromagnetic	adj.电磁的
electron	n.电子
elegance	n.高雅, 典雅, 优雅, 雅致
elegant	adj.雅致的
element	n.成分；要素
elementary	adj.基本的，初级的
elevate	vt.举起；抬高；使上升
elevation	n.高度，海拔
elevator	n.电梯，起重机；活动谷仓
elicit	vt.得出；引出
eligible	adj.合格的，有资格的
eliminate	vt.排除，剔除
elimination	n.排除，除去
elite	n.精英
elixir	n.长生不老药，万能药
elliptical	adj.椭圆的 adj.省略的
elongate	vt.延长，伸长
eloquent	adj.善于表达的，有口才的；雄辩的
elusive	adj.难懂的，难捉摸的
emancipate	vt.解放，释放
emancipation	n.释放，解放
embarrass	vt.使尴尬，使困窘
embed	vt.插入；镶嵌
embellish	vt.装饰，修饰
embellishment	n.装饰，修饰
emblem	n.象征，标志；徽章
embody	vt.使具体化；包含，收录
emboss	v.加浮雕花纹于，使凸出
embrace	vt.包含 vt.拥抱；欣然接受
embroider	vt.刺绣, 镶边；装饰
embroidery	n.刺绣
embryo	n.胚胎；事物的萌芽期
embryological	adj.胚胎学的
embryonic	adj.胚胎的，萌芽期的
emerge	vi.显现，浮现
emergence	n.浮现，出现
emerging	adj.正在不断出现的
emigrant	n.移居外国者，移民
eminence	n.显赫的声望
eminent	adj.显赫的，杰出的
emission	n.散发；发射
emit	vt.发出，放射
emotion	n.情绪，强烈的情感
emotional	adj.情绪的，情感的
emphasis	n.强调, 重点
emphasize	vt.强调, 着重
employ	vt.用，使用 vt.雇佣
employee	n.雇员
employer	n.雇主，老板
empty	adj.空的；空洞的，空虚的 vt.使成为空，倒空
enactment	n.设定，制定
encase	vt.装入，包住，围
enclose	vt.装入，放入封套；围绕
enclosure	n.围绕；围墙
encompass	vt.包括，包含 vt.环绕，围住
encounter	vt.遭遇，遇到
encourage	vt.鼓励，支持
encroach	vi.侵占，蚕食
encyclopedia	n.百科全书
endanger	vt.危及；危害
endangered	adj.有灭绝危险的，将要绝种的
endeavor	vi.尝试，努力 n.努力，尽力
endless	adj.无止境的
endlessly	adv.不断地，无穷尽地
endotherm	n.温血动物，恒温动物
endotoxin	n.内毒素
endow	vt.捐赠 vt.赋予
endowment	n.禀赋；捐款
endurance	n.忍耐（力），持久（力）
endure	vt.承受，忍受 vt.耐久
enduring	adj.持久的，不朽的
energetic	adj.精力充沛的；积极的
engaging	adj.动人的，迷人的
engrave	vt.雕刻，铭刻
engraving	n.雕刻术, 雕版, 雕版图
enhance	vt.提高，增加
enlightenment	n.启迪，教化
enormous	adj.极大的，庞大的
enrage	vt.激怒
enrich	vt.加料于(食物)；使富足，使肥沃
ensemble	n.全体，整体 n.合唱曲；剧团或文工团
entanglement	n.纠缠，缠绕物 n.累赘；牵连
enterprise	n.事业，企业
enterprising	adj.有进取心的,有事业心的,有魄力的
entertain	vt.娱乐；款待
entertainer	n.演艺人员
entertainment	n.娱乐；款待
enthusiasm	n.热心，热情
enthusiastically	adv.热心地；满腔热情地
entitle	v.取名叫，叫做 v.赋予权力
entitled	adj.有资格的
entity	n.存在物，实体
entrenched	adj.（权利、传统）确立的，牢固的
entrepreneur	n.企业家，创业人
entry	n.进口；入口 n.条目
envelop	v.把…包住，裹住
envision	vt.想象，预想
enzyme	n.酶
ephemeral	adj.短暂的，转瞬即逝的
epic	n.史诗，叙事诗
epidemic	n.传染病，流行病
epidermis	n.表皮
episode	n.一段情节；（音乐）插曲
epoch	n.新纪元，时代
equal	adj.相等的，同样的 vt.等于，比得上
equality	n.同等，平等
equestrian	adj.骑马的, (古罗马)市民特权阶层成员的, 骑士阶层的
equilibrium	n.平衡，均衡
equipment	n.设备
equitable	adj.公平的，公正的
equivalent	n.等同品 adj.相等的，等同的；等值的
eradicate	vt.根除，杜绝
erect	vt.使树立；建立，创立
erode	v.腐蚀，侵蚀
erosion	n.腐蚀，侵蚀
erratic	adj.古怪的，反复无常的
erratically	adv.不规则地
error	vt.做错，出差错
erupt	vi.喷出，爆发
eruption	n.爆发，喷发
escalate	vi.逐步升高, 逐步增强 vt.使逐步上升
escalator	n.电动扶梯
escape	v.逃脱，逃走；避开，避免
escapist	adj./n.逃避现实的（人）
essential	adj.绝对必要的；本质的，根本的
estate	n.财产；不动产
estimate	vt.估计
eternal	adj.永恒的；永远的
ethically	adv.在伦理上，道德上
ethics	n.伦理学；道德规范
ethnic	adj.种族的
etiquette	n.礼仪，礼节
evaluate	vt.评价，估价
evaporate	v.（使）蒸发，消失
evaporation	n.蒸发（作用）
eventful	adj.多事的,充满大事的;意义重大的
eventual	adj.最终的
eventually	adv.终于
evergreen	adj.常绿的 n.常绿树；常绿植物
everlasting	adj.永恒的，持久的，无止境的
evidence	n.证据 vt.证明；表明，显示
evident	adj.明显的
eviscerate	vt.取出内脏；除去主要部分
evoke	vt.引起，激起，唤起
evolution	n.发展，演变
evolutionary	adj.发展的，进化的
evolve	v.进化，发展
exact	adj.精确的，准确地
exacting	adj.苛求的，要求严格的
exaggerate	v.夸大，夸张
exaggeration	n.夸张
exalted	adj.崇高的，高贵的
excavate	vt.挖掘，挖出
excavation	n.挖掘
exceed	vt.超越，胜过
excel	vi.胜过，杰出
excellent	adj.优良的，杰出的
exception	n.例外
exceptional	adj.异常的，杰出的
exceptionally	adv.特殊地；异常地
excess	adj.过度的，额外的 n.过量，超过
excessive	adj.过度的，过分的，过多的
exchange	n./vt.兑换，交换
excite	vt.刺激，使兴奋
excitement	n.激动，兴奋；刺激
exciting	adj.令人兴奋的，刺激的
exclaim	vt.呼喊；惊叫
exclude	vt.把…排除在外，排斥
exclusion	n.排除，逐出
exclusive	adj.单独的，唯一的；排外的
exclusively	adv.排外地, 专有地
excursion	n.远足，游览
excuse	vt.原谅 n.藉口，理由
execute	vt.完成，实施，执行
execution	n.实施，执行；完成
executive	adj.行政的 n.执行者，经理主管人员
exemplary	adj.模范的，典范的，可仿效的
exemplify	vt.例证；作为…的例子
exempt	vt.使免除，豁免
exemption	n.解除，免除
exert	vt.运用，行使，施加
exertion	n.尽力，努力
exhale	vt.呼出，呼气
exhaust	n.排气，排气装置 vt.用尽，耗尽，使筋疲力尽
exhausted	adj.精疲力尽的
exhausting	adj.使用尽的, 令人疲乏不堪的
exhibit	vt.展现；展览
exhibition	n.展览会；展览品
exhilarate	vt.使人兴奋
exhilarating	adj.爽快的，使人愉快的
exit	n.出口
exorbitant	adj.（价格、索价）过高的，过分的
exotic	adj.异国的，外来的；奇异的
expand	v.扩大，膨胀；扩张
expanding	adj.扩大的，增加的
expanse	n.广阔的区域
expansion	n.扩张，发展
expedition	n.远征；探险队
expel	v.驱逐，开除；排出
expenditure	n.支出, 花费
expertise	n.专门技术，技能
expire	vi.期满，到期 vi.呼气
explicit	adj.明确的，清楚的
explode	vi.爆炸；爆发
exploit	vt.开拓；开采，开发
exploitation	n.开发，开采
exploration	n.勘察；探究
explore	vt.探险，勘探 vt.仔细检查，探究
explorer	n.探险家，探测者
explosive	adj.爆炸的；易爆发的 n.炸药
exponential	adj.指数的，幂数的
exposition	n.博览会，展览会
exposure	n.暴露；曝光
expressive	adj.有表现力的,富有表情的,生动的
expressly	adv.特意地，专门
extend	v.延长；扩大
extended	adj.延长的，扩大的
extension	n.延长，扩充
extensive	adj.广的；多方面的，广泛的
exterior	n.外部，外表
exterminate	v.根除，灭绝
external	adj.外部的
extinct	adj.灭绝的；不再活跃的，熄灭的
extinction	n.消失，灭绝
extol	vt.赞美
extract	vt.拔出；榨取 n.精，汁；榨出物
extraordinary	adj.特别的，非凡的
extremity	n.末端；极端，极度
exuberant	adj.充满活力的 adj.（植物）繁茂的
eye-catching	adj.引人注目的，耀眼的
eyewitness	n.目击者, 见证人
fable	n.寓言，神话
fabric	n.织物，布 n.结构，构造
facade	n.正面；表面
face	vt.面对
facelift	n.改建，表面修改
facet	n.面；（问题等的）方面
facilitate	vt.使容易；有助于，促进
facilitation	n.促进，帮助
facility	n.设施，设备
facsimile	n.复制品，传真
faction	n.派别，宗派，小集团
factor	n.因素；变量
factual	adj.事实的，实际的
faculty	n.教职工的总称 n.才能，能力
fade	vi.逐渐消失 vi.褪色，枯萎
faint	adj.微弱的；模糊的；无力的
fairly	adv.公平地；相当地
faithful	n.信徒 adj.忠实的
faithfulness	n.忠诚，诚实
fake	n.赝品，假货 adj.假的，伪造的
falcon	n.猎鹰
falconer	n.养猎鹰者，放鹰狩猎人
famine	n.饥荒，饥饿
fanatic	adj.狂热的；盲信的
fanatical	adj.狂热的，盲信的
fanaticism	n.狂热，盲信
fanciful	adj.爱空想的
fancy	adj.新奇的，精美的
fantastic	adj.（非正式）极…的；奇异的
fantasy	n.幻想；白日梦
far-reaching	adj.影响深远的
farce	n.闹剧，滑稽剧
fascinate	vt.使着迷，使神魂颠倒
fascinating	adj.迷人的，醉人的
fascination	n.入迷，迷恋；魅力
fashion	n.流行，风尚，流行式样 vt.塑造，造
fashionable	adj.流行的，时髦的，上流社会的
fasten	vt.使固定，系
fatal	adj.致命的
fateful	adj.重大的，决定性的
fatigue	n.疲乏，劳累
faucet	n.水龙头
fault	n.（地质学）断层 n.过错，缺点
fauna	n.动物群，动物区系
favorable	adj.有利的；有助的；赢得赞扬的
favored	adj.首选的；受到优待的；受优惠的
feasible	adj.切实可行的
feat	n.功绩，壮举
feeble	adj.微弱的；衰弱的
feed	v.喂养，饲养；吃草，靠…为生 n.饲养，饲料
feeder	n.进料器
feminism	n.女权运动
feminist	n.女权主义者
fencing	n.围墙，栅栏；击剑，剑术
fender	n.防卫物；挡泥板
ferment	vt.使发酵 n./vt.（使）激动，（使）动乱
fermentation	n.发酵
ferromagnetic	adj.铁磁的, 铁磁体
ferry	n.渡口；渡船
fertile	adj.肥沃的，富饶的；能繁殖的 adj.主意多的，有创造力的
fertilize	vt.施肥，使丰饶；使受精
fertilizer	n.肥料
fervor	n.热情，热烈
festival	n.节日
festive	adj.欢宴的，节日的
feud	n.世仇
feudal	adj.封建制度的
feverish	adj.发烧的 adj.狂热的，兴奋的
fiber	n.纤维，光纤
fiction	n.小说，（虚构）故事
fictional	adj.虚构的
fidelity	n.忠实，忠诚
fierce	adj.凶猛的
figurehead	n.装饰船头的雕像, 破浪神, 有名无实的领袖
file	n.档案 n.队列，纵队 v.归档
filter	vt.过滤 n.过滤器
finance	n.财政，拨款 vt.资助
financial	adj.财政的
financing	n.筹措资金
finch	n.雀类
finesse	n.精密技巧，灵巧 n.手腕
fingertip	n.指尖
fir	n.杉木
fireproof	adj.耐火的，防火的
firm	adj.结实的；坚定的
fishy	adj.鱼的，鱼味的；腥臭的
fitness	n.健康
fittingly	adv.适当地
fixed	adj.固定的；不变的
fixture	n.固定设备
flabby	adj.（肌肉等）不结实的，松弛的
flag	n.旗，标记 vi.衰退，低落 
flagella	n.鞭节，鞭毛
flair	n.才能，本领
flake	n.薄片   vt. 使成薄片
flamboyant	adj.艳丽的，炫耀的
flare	n.闪光；闪耀 vi.闪光，闪耀；突然爆发或燃烧
flash	n./vi.闪光；闪现
flashlight	n.手电筒；闪光灯
flashy	adj.浮华的
flavor	n.味，风味 vt.加香味于
flavoring	n.调味品，调料
flea	n.跳蚤
fleeting	adj.短暂的，飞逝的
flexibility	n.灵活性
flexible	adj.易弯曲的，柔软的；变通的
flickering	adj.闪烁的，摇曳的，一闪一闪的
flint	n.打火石
float	v.漂浮，使漂浮
flock	n.（畜、禽）群，大量 v.蜂拥，群集
floodplain	n.泛滥平原, 涝原, 漫滩
flora	n.某一地区或时期的植物总称
floral	adj.花的，植物的
flounder	n.比目鱼 v.挣扎，艰难地移动
flourish	vi.繁荣，茂盛；健康成长 n.挥舞
fluctuate	vi.波动，起伏
fluctuation	n.波动，起伏
fluent	adj.流利的；流畅的
fluffy	adj.绒毛的，松软的
fluorescent	adj.荧光的, 莹光的
flux	n.变迁；涨潮
flyspeck	n.蝇粪留下的污点, 污点
foe	n.敌人，敌军
fog	n.雾
fogged	adj.[摄]有灰雾的,不清晰的
foggy	adj.雾深的, 模糊的
foghorn	n.雾号（浓雾信号）
fold	v.折叠 n.折痕，折
folding	adj.可折叠的
foliage	n.树叶，植物
folklore	n.民间传说
folly	n.愚笨，愚蠢，荒唐事
foment	v.煽动，助长
foolish	adj.愚蠢的
footnote	n.脚注
footpath	n.人行道，小路
forage	n.草料
foray	n.袭击
forbid	v.禁止
forbidding	adj.可怕的，令人难以亲近的，令人生畏的
ford	n.浅滩，水浅可涉处
forebear	n.祖先
forecast	n.预测，预报 v.预测
forefather	n.祖先，祖宗
forefront	n.最前沿
foremost	adj.最重要的；最先的
forerunner	n.先驱，前身；预兆
foresee	vt.预见，预知
foreshadow	vt.成为先兆，预示
foresight	n.远见，深谋远虑
forestall	vt.预防，预先阻止
foretell	v.预示，预测
forge	v.铸造，伪造
formal	adj.正式的；形式的；合乎礼仪的
formalized	adj.形式化的，使程序化的
format	n.模式，格式
formation	n.形成，构成
formative	adj.形成中的，发展中的
former	adj.从前的，以前的
formerly	adv.从前，以前
formidable	adj.令人敬畏的，可怕的
formula	n.公式；规则
formulate	vt.系统地阐述（或提出）
fort	n.要塞，堡垒
fortify	vt.加强，巩固
fortress	n.要塞；城堡
fortuitous	adj.偶然的，意外的
fortuitously	adv.偶然地，意外地
fortunate	adj.幸运的
fortune	n.财富；运气
fossil	n.化石；僵化的事物
fossilize	vt.使成化石
fossilized	adj.变成化石的
foster	vt.鼓励，促进 vt.养育，抚养
foul	adj.污秽的，肮脏的
founder	n.创建者，创始人
fraction	n.小部分，少量 n.分数
fracture	n.骨折；破裂 vt.使破裂，断裂
fragile	adj.易碎的，脆的；脆弱的
fragility	n.脆弱
fragment	n.碎片，破片
fragrance	n.芬芳，香味
fragrant	adj.香的，芬芳的
frame	n.框架 vt.加外框 vt.提出，制定
framework	n.构架；骨架
frank	adj.坦白的，直率的
fray	vt.使磨损
freight	n.货物，货运 vt.装货，运送
freighter	n.货车
frenetic	adj.狂乱的，发狂的
frenzy	n.狂暴；狂怒
fresco	n.壁画 vt.作壁画于
freshly	adv.新近，最近
freshness	n.新鲜；活力
friction	n.摩擦 n.冲突，不和
frightening	adj.令人恐惧的，引起突然惊恐的
frigid	adj.寒冷的；冷淡的
fringe	n.边缘；边界 adj.边缘的
frisky	adj.活泼的，欢闹的
frivolity	n.轻浮
frost	n.霜；霜冻 vi.结霜
frown	vi.皱眉；不赞成，反对
frugal	adj.节约的，节俭的
frugality	n.节约，俭省
fruitful	adj.硕果累累的；成功的
fruitfulness	n.硕果累累；多产
fruitless	adj.不结果实的，无收获的
fruitlessly	adv.徒劳地
frustrate	v.挫败，破坏 v.使沮丧
frustrating	adj.令人沮丧胆
frustration	n.挫败，挫折
fume	n.烟，气体
fumigate	vt.烟熏；用香薰
functional	adj.功能的；有用的
functioning	n.运转，操作
fund	n.资金；基金 vt.提供资金
fundamental	adj.基础的，基本的
funding	n.拨款
fungi	n.（fungus的复数）真菌
furious	adj.狂怒的；狂暴的
furnish	vt.装备；提供
furnishing	n.（家庭中包含家具及其他）设备的总称
furniture	n.家具
furry	adj.毛皮的；盖着皮毛的
further	vt.促进，增进 adj.更多的，另外的
fuse	v.熔合
fused	adj.熔合在一起的
fusion	n.核聚变 n.熔化；联合
galaxy	n.星系；银河
gallant	adj.(对女子)殷勤的;勇敢的,英勇的
gallantry	n.勇敢
gallery	n.画廊，美术馆
galvanization	n.镀锌；电镀
galvanize	vt.通电流于；刺激，激起
gap	n.裂口；缺口 n.差距
garb	n.服装，装束
garbage	n.垃圾，废物
gaseous	adj.气体的，气态的
gasoline	n.汽油
gauge	v.测量，计量；评价，估计 n.量规，量表
gazette	n.政府公报
gear	n.齿轮，传动装置 v.使适合，使一致
gem	n.宝石，珠宝
gemstone	n.经雕琢的宝石
generalization	n.概括
generalize	vt.归纳，概括
generate	vt.造成，产生 vt.产卵
generous	adj.慷慨的 adj.大量的
genesis	n.起源，产生
genetic	adj.遗传的，起源的
genetically	adv.遗传上
genetics	n.遗传学
genial	adj.和蔼可亲的
genre	n.文学上的流派和体裁
gentility	n.有教养，文雅
genuine	adj.真正的，真实的；真诚的
geomagnetic	adj.地磁的
germ	n.细菌
giant	n.巨人，巨大的怪物 adj.庞大的，巨大的
gibe	vi.嘲弄，讥笑
gigantic	adj.巨大的
gilding	n.贴金箔，镀金
girder	n.钢结构大梁
glacial	adj.冰的，冰河的；冰冷的
glacier	n.冰川
glamorous	adj.迷人的，富有魅力的
gland	n.腺体
glandular	adj.腺体的
glare	n.眩目的光 v.闪耀
glassware	n.玻璃器具
glaze	vt.装玻璃，上釉，使表面光滑 n.釉料
glazed	adj.上过釉的，表面光滑的
glean	v.点滴搜集；拾
glide	vi.滑动，滑行
glider	n.滑行者；滑翔机
glimpse	n.一瞥，一看 v.瞥见
global	adj.全球性的
glorify	v.美化，赞扬
glossy	adj.平滑的，有光泽的
glowing	adj.白热的，通红的
gnaw	v.咬，啃
goal	n.目标
gorgeous	adj.华丽的；灿烂的
gorilla	n.大猩猩
gospel	n.福音
gossip	n.社会新闻，小道传闻
gourmand	n.嗜食者
gourmet	n.美食家
govern	vt.统治，管理；控制
governor	n.州长；总督
grab	vt.攫取，抓住
grace	n.风度
graceful	adj.优雅的
graduate	n.(大学)毕业生, 研究生
graft	vt.嫁接，接枝
grand	adj.壮观的；显赫的
grandeur	n.庄严，伟大
granite	n.花岗岩
graph	n.图表
graphic	adj.绘画似的；图解的，生动的
graphics	n.（作单数用）制图法，制图学
graphite	n.石墨
grasp	vt.抓住，抓紧 n.掌握，领会
grasshopper	n.蚱蜢，蚂蚱
grateful	adj.感激的，感谢的
gravitation	n.引力，重力
gravitational	adj.地心引力的，重力的
gravity	n.地心引力 n.严肃，一本正经
graze	v.放牧，吃草
grease	n.油脂
greedy	adj.贪婪的
grind	vt.磨碎，碾碎
grip	v.紧握，紧抓
grope	vi.摸索，探索
grumble	n./v.抱怨
guarantee	vt.保证，担保
gulf	n.海湾
gull	n.鸥，海鸥
gulp	n./vt.吞；吞咽
gush	vi.喷涌，涌流
gust	n.一阵强风
gymnastic	adj.体操的，体育的
gymnastics	n.体操，体育
gyration	n.旋转
habitat	n.栖息地，居留地
hail	n.冰雹 vt.致敬，向…欢呼
hallmark	n.标志，特征
halt	n./vt.（使）停止
ham	n.火腿；大腿
hamburger	n.汉堡包
hamper	vt.妨碍，使困难
handful	n.一把, 少数
handicap	n.残疾 vt.严重妨碍，削弱
handicraft	n.手工艺品
hands-on	亲手抓的
handy	adj.便利的，容易取得的
haphazard	adj.偶然的；随便的
harbor	n.海港 n.避难所
harden	v.使变硬
hardware	n.五金器具，硬件
hardy	adj.能吃苦耐劳的，强壮的
harmful	adj.有害的；伤害的
harmless	adj.无害的
harmonic	adj.和声的
harmonica	n.口琴
harmonious	adj.和谐的
harmonize	v.（使）协调，（使）和谐
harmony	n.协调，融洽
harness	vt.利用（河流、瀑布等）产生动力 n.（全套）马具
harsh	adj.粗糙的；刺耳的，刻薄的 adj.严厉的；严酷的，恶劣的
harshness	n.严酷，恶劣
harvest	v.收获，收割
haste	n.匆忙，急忙；草率
hasten	vt.加速
hatch	vt.孵化
hatchery	n.孵卵所
hatchet	n.短柄斧
hatchling	n.人工孵化的鱼苗或小鸟
haul	vt.拉，拖
haunt	vt.（思想、回忆等）萦绕心头 n.常去的地方
haunted	adj.闹鬼的,鬼魂出没的,受到折磨的
haven	n.避难所，安全地
hay	n.干草
hazard	n.危险；危害物
hazardous	adj.危险的，冒险的
haze	n.薄雾
hazel	adj.榛树的
headquarters	n.司令部，总部
heal	v.康复，治愈
healing	adj.有治疗作用的
healthful	adj.有益健康的
heaven	n.天，天堂
heavenly	adj.天空的，天上的
heed	n./v.注意，留意
heel	n.脚后跟
heighten	vt.提高，升高；加深
heir	n.继承人，后嗣
helium	n.氦
helper	n.助手
helpful	adj.有帮助的，有益的
helpless	adj.无助的，无依靠的
hem	n.（衣服或裙子）褶边，边缘
hemisphere	n.半球
herald	vt.宣布…的消息；预示…的来临
herculean	adj.力大无比的, 巨大的
herd	n.兽群；人群 vt.把…赶在一起放牧；成群，群集
herder	n.牧者，牧人
heredity	n.遗传
heritage	n.遗产；继承物
heroism	n.英雄品质，英勇
hesitate	vi.犹豫，踌躇
hestiant	adj.迟疑的，犹豫不定的
heterogeneous	adj.异类的，不同的
heyday	n.全盛期
hibernate	vi.冬眠
hibernation	n.冬眠
hide	n.兽皮 vi.隐藏，掩藏
hierarchy	n.阶层，等级制度
highlight	vt.使显著，突出 n.最显著（重要）部分
hike	v.远足，徒步旅行 n.徒步旅行
hillbilly	n.山地内部的贫农，山里人
hilly	adj.多小山的，多坡的
hinder	vt.阻碍，妨碍
hinge	n.（门等）铰链，枢纽
hint	n.提示，线索
hinterland	n.穷乡僻壤；腹地
hoe	vt.用锄耕地，锄
hollow	adj.空心的，凹陷的 adj.空洞的 vt.形成空洞；挖空 n.洞；山谷
homemade	adj.自制的，家里做的
homesick	adj.思家的，思乡病的
homespun	adj.朴素的；家里纺织的
homogeneous	adj.同类的；均匀的，同质的
homogenize	vt.使均匀
horde	n.一大群
horizon	n.地平线；眼界，视野
horizontal	adj.水平的
horn	n.（牛羊等的）角
hornbill	n.犀鸟，犀鸟科
horned	adj.有角的，角状的
hornet	n.大黄蜂类
horror	n.惊骇；恐怖
horticulture	n.园艺
hospitable	adj.好客的
hostile	adj.敌对的，不友好的
hostility	n.敌意，敌对
house	vt.给…提供住所
hover	vi.翱翔；徘徊
hovercraft	n.水翼船
hub	n.轮轴 n.活动中心
huddle	vi.缩成一团；挤成一团 n.杂乱的一堆，拥挤
hue	n.颜色，色彩
humanist	n.人道主义者，人文主义者
humanistic	adj.人性的；人文主义的
humanitarian	n./adj.人道主义者；人道主义的
humanity	n.人性；博爱，仁慈
humble	adj.卑贱的；谦逊的
humid	adj.潮湿的
humidity	n.湿气，湿度
humiliate	vt.羞辱，使丢脸
humility	n.谦卑
hummingbird	n.蜂鸟
humorous	adj.幽默的，滑稽的
hump	n.驼背；峰，圆形隆起之物
hunger	n.饥饿
hurl	vt.用力投掷
hurricane	n.飓风
husk	n.（果类或谷物）外壳；皮 vt.剥…的壳；削皮
hustle	n.挤，推，拥挤喧嚷
hydrogen	n.氢
hydrosphere	n.水圈, 水气, 水界
hygiene	n.卫生
hypersensitive	adj.非常敏感的
hypothesis	n.假设
hypothesize	vt.假设，假定
iceberg	n.冰山
icicle	n.冰柱，冰垂
icon	n.圣像，偶像 n.图标
iconographic	adj.图解的
identical	adj.同一的；完全相同的
identifiable	adj.可辨认的
identification	n.辨认；鉴定
identify	vt.识别，认出；鉴定
identity	n.身份
ideological	adj.意识形态的
ideology	n.意识形态
idiom	n.方言，土语；习惯用语
idiomatic	adj.惯用的，通顺的
idyllic	adj.田园诗的
igneous	adj.（地理）火的，火成的
ignite	v.点燃，使燃着
ignorance	n.无知，不了解
ignorant	adj.无知的；不了解的
ignore	vt.忽视；不顾，不理会
illegible	adj.难辨认的，字迹模糊的
illiterate	adj.不识字的，没受教育的
illuminate	v.照明，照亮 v.说明，阐明
illumination	n.照明；启发
illusion	n.幻觉；错觉
illusive	adj.迷惑人的；错觉的
illustrate	vt.（用图或例子）说明，阐明
illustration	n.例证；插图
image	n.图像，肖像；形象
imagery	n.（艺术、文学）肖像，形象；形象化的比喻
imaginary	adj.想象中的，虚构的
imaginative	adj.富于想象力的
imbalance	n.不平衡，不均衡
imbibe	v.吸；吸收
imitate	vt.仿效，模仿
imitation	n.模仿；仿制品
immediate	adj.立即的；（在时空上、关系上）最接近的；目前的
immediately	adv.立即，马上
immense	adj.巨大的；无边的
immigrant	n.（从外国移入的）移民，侨民
immigration	n.外来的移民, 移居入境
immobile	adj.稳定的，不动的，静止的
immobilize	vt.使不动，使固定
immune	adj.（对…）免疫的，不受影响的
immunity	n.免疫性
impact	n.影响 n.撞击，冲击
impair	vt.损害，使弱
impart	vt.传授；传递，传达
impartial	adj.公正的，无偏见的
impartially	adv.公平地，无私地
impede	vt.妨碍，阻碍
impediment	n.妨碍，阻碍（物）
impending	adj.即将发生的，逼近的
imperative	adj.必要的；强制的 n.命令；需要，必要的事
impermeable	adj.不可渗透的；不透水的
impersonal	adj.不受个人感情支配的，客观的，无私的
impersonate	vt.模仿，扮演
impersonation	n.模仿，扮演
impetus	n.推动力；激励物
implement	n.工具，器具 vt.实行，实施
implication	n.暗示，意义 n.牵连
implicit	adj.不明确的，含蓄的
imply	vt.暗示，意味
import	vt./n.（贸易）进口
impose	vt.把…强加于；施加影响
imposing	adj.使人难忘的, 壮丽的
impracticality	n.不切实际, 办不到
impressive	adj.给人深刻印象的；威严的
imprint	n.印痕，痕迹；深刻的印象 vt.压印，牢记
imprisonment	n.监禁
improbable	adj.不可能的
improvise	vt.即席创作，即兴表演
improviser	n.即席演奏者
improvision	n.即席创作
impulse	n.推动，刺激；冲动
inability	n.无能，无力
inaccessible	adj.难达到的,不可及的;不能得到的
inactivate	vt.使…不活跃
inadequate	adj.不充分的，不适当的
inanimate	adj.无生命的
inappropriate	adj.不适当的，不相称的
inaugurate	v.创新，开辟 v.使就职
incandescent	adj.遇热发光的, 白炽的
incapacitate	vt.使失去能力；使不胜任
incense	n.熏香；焚香的烟 vt.激怒
incentive	n.动机
incessant	adj.不停的，连续的
incidence	n.发生，出现；发生频率
incident	n.事件
incidentally	adv.附带地，偶然地
incise	vt.切割
incisive	adj.深刻的，尖锐的
inclination	n.嗜好，倾向
inclined	adj.倾向…的 adj.倾斜的，有坡度的
inclusive	adj.包含的，包括的
incompatible	adj.合不来的,相互不协调的;不兼容的
incomprehensible	adj.不能理解的，费解的
inconclusive	adj.非决定的
incongruity	n.不一致，不和谐
incongruous	adj.不协调的，不一致的
inconvenient	adj.不便的，有困难的
incorpoarate	vt.合并，并入；包含
incorporation	n.结合，合并
incredible	adj.难以置信的，惊人的
incredulity	n.怀疑，不相信
incur	vt.招致，引起
indefinite	adj.模糊的；不明确的
indefinitely	adv.不确定地；无穷尽地
indent	vt.切割成锯齿状
indented	adj.锯齿状的，高低不平的
indenture	vt.以契约约束
independent	adj.独立自主的，不受约束的 n.中立派，无党派者
indicate	vt.指示，指出；象征，表明
indicative	adj.指示的，预示的
indifference	n.冷漠，不关心
indifferent	adj.不感兴趣的，漠不关心的
indigestion	n.消化不良
indiscriminately	adv.随意地；不加区别地
indiscrimination	n.歧视
indispensable	adj.不可缺少的，必需的
individualism	n.个人主义
induce	vt.诱使，促使；导致
inducible	adj.可诱导的
industrial	adj.工业的
industrialization	n.工业化
industrialized	vt.工业化的
industrious	adj.勤勉的
inelastic	adj.无弹性的
ineligible	adj.无资格的；不适当的
inert	adj.惰性的；不活泼的
inevitably	adv.不可避免地，必然地
inextricably	adv.无法摆脱地
infancy	n.幼年
infection	n.传染（病）
infectious	adj.传染性的，易传染的
inferior	adj.（等级、社会地位、质量等）差的；（较）低的
inferiority	n.自卑感
infertile	adj.不肥沃的
infest	vt.骚扰，大批滋生
infiltrate	vt.使透过，渗透
infirmary	n.医院, 医务室<美>养老院, 救济院
inflate	vt.使膨胀，使充气
inflation	n.通货膨胀
inflexible	adj.坚定的
inflict	vt.造成；(使)遭受(痛苦、损伤等)
influential	adj.有影响的；有权势的
influenza	n.流行性感冒
influx	n.流入，汇集
informal	adj.不拘礼节的，随便的；非正式的
informative	adj.提供消息的，见闻广博的
informed	adj.受过教育的，见多识广的
infuse	vt.注入，灌输
infusion	n.注入
ingenious	adj.机灵的，有独创性的
ingeniously	adv.天才地，独创地
ingredient	n.配料，成份
inhabit	vt.居住于，栖息于
inhabitant	n.居民，住户
inherent	adj.固有的，内在的
inherit	vt.继承
inheritance	n.遗产
inhibit	vt.抑制；阻止
initial	adj.最初的，初始的 n.开头大写字母
initially	adv.最初，开头
initiate	vt.开始，发起
inject	vt.注射；注入，灌溉
injury	n.伤害，侮辱
injustice	n.不公平，不讲道义
innate	adj.先天的，天生的
innermost	adj.最里面的；内心的，秘密的
innocent	adj.无辜的，清白的；天真的
innovation	n.改革，创新
innovative	adj.创新的，革新的
innumerable	adj.无数的，数不清的
inoffensive	adj.无害的,不触犯人的,让人不讨厌的
inpractical	adj.不切实际的
inquiry	n.质问；调查
insanity	n.精神错乱，疯狂
insert	vt.插入
insight	n.洞察力，见识
insignificant	adj.无关紧要的, 可忽略的, 无意义的
insist	vt.坚持认为；坚决主张
insistence	n.坚持
inspect	vt.检查；审查
inspection	n.检查，细看
inspector	n.检查员，巡视员
inspiration	n.灵感
inspire	vt.鼓舞；给…以灵感
inspiring	adj.使人振奋的，鼓舞的
install	vt.安装，设置
installment	n.分期付款
instantaneous	adj.瞬间的，即刻的
instinct	n.本能，直觉
instinctive	adj.天生的，本能的
instinctively	adv.本能地；凭直觉地
institute	n.学院；学会，协会 vt.开始；制定
institution	n.机构；惯例
institutionalize	v.使制度化
instruct	vt.教；命令
instruction	n.命令，指示；教学
instructive	adj.有益的；教育性的
instrument	n.仪器；工具；乐器
instrumental	adj.有帮助的，可作为手段的 adj.器具的
instrumentalist	n.器乐家，器乐演奏者
insufficient	adj.不足的，不够的
insulation	n.绝缘；隔离；孤立
insulin	n.胰岛素
insult	vt.侮辱，凌辱
insulting	adj.侮辱性的，欺负人的
insurmountable	adj.不能克服的, 不能超越的
intact	adj.尚未被人碰到的，完整的
integral	adj.整体的；构成整体所需的
integrate	vt.使成为整体，使一体化
integrated	adj.整合的，一体化的
integrity	n.完整性；正直，诚实
intellect	n.智力
intellectual	n.知识分子   adj. 智力的
intelligence	n.智力；聪明
intelligent	adj.聪明的，有才智的
intelligible	adj.明了的，可理解的
intense	adj.强烈的，剧烈的
intensify	vt.加强；扩大
intensive	adj.加强的；集中的，密集的
intention	n.意图，目的=intent
intentionally	adv.有意地，特意地
interact	vi.互相作用，互相影响
interaction	n.相互作用
interactive	adj.交互式的
interconnected	adj.相互连接的
interconnecting	adj.相互连接的
interdependence	n.互相依赖
interdependent	adj.相互依赖的，互助的
interest	n.兴趣；利息
interfere	vi.妨碍；干涉
interference	n.冲突；干涉
interior	n./adj.内部（的）
interlocking	adj.连锁的，关联的
intermediate	adj.中间的；中级的
intermittent	adj.间歇的，断断续续的
internal	adj.内在的
interpersonal	adj.人与人之间的；关于人与人之间关系的
interpretation	n.解释
interrupt	vt.打断，使中断
intersect	vi.相交
intersected	adj.分割的
intersection	n.十字路口, 交叉点
interstellar	adj.星际的
interval	n.间隔时间
intervention	n.干涉，介入
intimacy	n.亲密，熟悉
intimate	adj.亲密的 adj.（知识）渊博的
intoxication	n.陶醉
intrepid	adj.勇敢的
intricate	adj.复杂的，错综的
intricately	adv.杂乱地
intrigue	vt.激起…的兴趣
intriguing	adj.吸引人的,引起兴趣(或好奇心)的
intrinsic	adj.固有的，内在的
introspective	adj.自省的，反省的
intruder	n.入侵者，闯入者
intruding	adj.入侵性的
intrusion	n.侵扰，干扰
inundate	vt.淹没
invade	vt.侵略，侵犯
invader	n.侵略者
invariably	adv.不变地，总是
invasion	n.入侵
inventory	n.存货清单；库存品
invertebrate	n.无脊椎动物
investigate	vt.调查，研究
investigation	n.调查
inviting	adj.诱人的，引人心动的
involuntary	adj.自然而然的，无意的
ion	n.离子
ionosphere	n.电离层
ironic	adj.讽刺的
irony	n.反讽，讽刺
irradiate	vt.照射
irregular	adj.不规则的，不整齐的
irregularly	adv.不规则地
irrelevant	adj.不相关的，不切题的
irreparable	adj.不能挽回的
irresistible	adj.不可抵抗的, 不能压制的
irresponsible	adj.不负责任的，不可靠的
irreverence	n.不尊敬
irreverent	adj.不尊敬的
irreversible	adj.不能撤回的，不能取消的
irrevocable	adj.不能取消的
irrigate	vt.灌溉
irrigation	n.灌溉
irritable	adj.易怒的，急躁的
irritate	vt.激怒；使过敏
irritating	adj.刺激的；使人愤怒的，气人的
isolate	vt.使隔离，使孤立
isolated	adj.与世隔绝的，偏僻的；孤独的
isolation	n.隔离；孤立
issue	n.问题 n.（报刊的）期 v.发行
iterate	vt.反复说，重申
itinerant	adj.巡回的
itinerary	n.路线
jar	n.罐，广口瓶 vt.震动；刺激，震惊
jealousy	n.妒忌，羡慕
jelly	n.果冻，胶状物
jellyfish	n.水母
jewel	n.宝石
jeweler	n.宝石商，宝石匠
jewelry	n.珠宝
jog	vi.慢跑
jogging	n.慢跑
jolt	n.震动，颠簸 vt.使颠簸，猛击
jolting	adj.令人震惊的
journal	n.期刊，杂志 n.（航海）日记；分类帐
journalism	n.新闻业, 报章杂志
journalist	n.新闻记者
journalistic	adj.新闻事业的，新闻工作的
jubilant	adj.欢腾的，喜气洋洋的
judgement	n.判决
judicious	adj.明智的；有判断力的
juice	n.（水果）汁，液
juicy	adj.多汁液的
jumble	vt.使混乱，混杂 n.混乱；杂乱的一堆
junction	n.连接；汇合处
juncture	n.接合，接缝
jungle	n.丛林
jurisdiction	n.权限；管辖范围
jury	n.陪审团
justice	n.正义，公平，公正
justify	vt.证明…是正当的或有理的；为…辩护
justly	adv.公正地，正当地
juvenile	n./adj.青少年（的）
juxtaposition	n.毗邻，并置，并列
keen	adj.（感觉、观察、理解等）敏锐的，敏捷的 adj.锋利的
ken	n.视野，知识领域
kennel	n.狗舍，狗窝
kernel	n.仁，核心；(去壳的)麦粒，谷粒
kerosene	n.煤油
keyboard	n.键盘
kiln	n.（砖、石灰等）窑，炉
kinetic	adj.运动的；动力学的
kingdom	n.王国
knapsack	n.(士兵或徒步旅行者用的帆布或皮制的)背包
kymograph	n.波动曲线记录仪
laborer	n.劳动者
laborious	adj.费力的，艰难的
laboriously	adv.费力地，艰难地
labyrinth	n.迷宫；错综复杂的事件
lace	n.饰带，花边 n.带子；鞋带 vt.装饰，点缀
lag	vi.落后
lament	vt.为…悲痛，痛惜
lampshade	n.灯罩
landing	n.着陆，降落
landmass	n.大片陆地
landscape	n.风景，山水；风景画
landslide	n.[地]山崩
largely	adv.大量地，大半地
larvae	n.幼虫
larynx	n.[解] 喉
laser	n.激光
lash	n.鞭子 v.抽打，鞭打
lasting	adj.持久的；永恒的，耐力的
latent	adj.潜伏的，隐藏的
lateral	adj.侧面的，旁边的
latitude	n.纬度，范围 n.行动或言论的自由（范围）
launch	vt.发动 n./v.发射，（使）升空
laundry	n.洗衣店, 要洗的衣服
laurels	n.桂冠，荣誉
lava	n.熔岩，岩浆
lave	vt.为沐浴, 洗
lavish	adj.过分丰富的；浪费的
lawn	n.草地，草坪，草场
lawsuit	n.诉讼(尤指非刑事案件)
lay	vt.产卵，下蛋
layer	n.层，层次；阶层
layering	n.分层堆积
layman	n.俗人，犯人；外行
layout	n.规划，设计
leadership	n.领导能力，领导阶层
leading	adj.最主要的 adj.主演的
league	n.同盟，联盟；联合会
leak	vt.漏；渗 vt.泄露
leaky	adj.漏的
leap	n./vi.跳跃
lease	n.租约 vt.出租，租借
ledge	n.壁架, 架状突出物, 暗礁, 矿层
legacy	n.遗产，遗物
legend	n.传说；传奇文学
legendary	adj.传奇的
legible	adj.(指印刷或字迹)清楚地，易读的
legislate	vt.立法
legislation	n.立法 n.法规
legislature	n.立法机关
legume	n.豆类，豆荚
leisure	n.空闲，闲暇
leisurely	adj.从容的，悠闲的
lengthen	vt.延长，使变长
lengthy	adj.(演说、文章等)冗长的，啰嗦的
leopard	n.豹，美洲豹
lethal	adj.致命的
lethargic	adj.昏睡的；懒洋洋的，萎靡不振的
lethargy	n.昏睡，倦怠
lettuce	n.莴苣，生菜
libel	n.以文字损害名誉，诽谤
liberal	adj.开放的,主张变革的,自由主义的 adj.慷慨的，不拘泥的
liberally	adv.随意地，不受限制地
liberate	vt.释放，使自由
liberty	n.自由
lifesaver	n.救生者, 水难救生员
lift	v.举起，升高
likewise	adv.同样地，也
limb	n.肢，翼；树枝
limestone	n.石灰石
lineage	n.血统，世系
linen	n.亚麻布，亚麻制品
linger	vi.逗留；徘徊
linguistic	adj.语言上的，语言学上的
linguistics	n.语言学
liquid	n.液体，流体 adj.液体的
literacy	n.有读写能力，识字
literally	adv.照字面意义地，逐字地
literary	adj.文学（上）的，从事写作的
literate	adj.有文化的，有阅读和写作能力的
lithograph	n.平板印刷，平板画
lithosphere	n.[地]岩石圈
litter	vt.乱丢 vi.乱丢垃圾 n.垃圾
livelihood	n.生计，谋生
lively	adj.活泼的，活跃的；栩栩如生的
liver	n.肝脏
livestock	n.家畜，牲畜
load	n.重担；重任 vt.装载，使负担
loathsome	adj.令人讨厌的
lobby	n.大厅，休息厅 v.游说议员
lobster	n.龙虾
locality	n.位置，地方
locally	adv.在地方上，在当地
locate	vt.找出，定位；设置
location	n.位置，场所
locomote	v.移动，行动
locomotion	n.运动，移动
locomotive	n.火车头
locoweed	n.[植] 疯草(牲畜食后引起疯草病)
lodge	n.（山林）小屋 vi.寄存；临时住宿
lodging	n.寄宿，住房（常指出租的房间）
log	n.圆木；航海日志；vt. 记录
logic	n.逻辑，逻辑学
logical	adj.合乎逻辑的，合理的
long-lasting	adj.持久的，永久的
long-range	远程的
long-standing	adj.长期存在的
longevity	n.长寿
longitude	n.经度，经线
loom	n.织布机 vi.隐约闪现，逼近
loop	vt.把…圈成环；缠绕 n.圈，环
loose	adj.宽松的；不牢固的
loosen	vt.解开，放松
lore	n.口头传说；学问，知识
lucrative	adj.赚钱的，有利可图的
lull	vt.使平静；使安静
lumber	n.木材，木料
lumbering	n.采伐林木
luminosity	n.亮度，发光度
luminous	adj.发光的；明亮的
lunar	adj.月的
lure	vt.引诱，诱惑 n.饵；诱惑
luster	n.光彩，光泽；声望
lustrous	adj.有光泽的；光辉的
luxurious	adj.奢侈的，豪华的
luxury	n.奢侈，豪华
lyric	n.抒情诗；歌词
lyrically	adv.抒情地
lyricist	n.抒情诗人
magic	n.魔法，魔力；魔术
magical	adj.魔术的，不可思议的
magician	n.魔术师，变戏法的人
magnesium	n.镁
magnetic	n.磁铁
magnetism	n.磁，磁力
magnetize	vt.使磁化；吸引
magnetosphere	n.磁气圈
magnificence	n.华丽，富丽堂皇
magnificent	adj.华丽的；高尚的；丰富的
magnify	vt.放大，扩大
magnitude	n.大小，光度，重要
mainspring	n.(钟表的)主发条
maintenance	n.维修，保养 n.维持，继续
maize	n.玉米
majestic	adj.壮观的，庄严的
majesty	n.威严，最高权威
majority	n.多数
makeup	n.组成，结构 n.补考 n.化妆品
malfunction	n.故障，失灵
malfunctional	adj.多功能的
mall	n.大规模购物中心
malleability	n.可锻性，可塑性，延展性
malleable	adj.可锻的，可塑的，可延展的
mallet	n.槌棒
malnutrition	n.营养不良
mammal	n.哺乳动物
mammoth	n.猛犸象 adj.巨大的
mandate	n.命令，要求
mandatory	adj.命令的，强制的
maneuver	vt.(敏捷地)操纵；(用策略)调动 n.策略，谋略
mania	n.狂热
manifestation	n.表现，显示
manipulate	vt.操作；操纵，利用
mannerism	n.特殊习惯，怪癖
mansion	n.大厦；公寓
mantle	n.地幔；覆盖物
manual	n.手册 adj.人工的，手动的
manually	adv.用手
manure	n.肥料
map	vt.绘制…的地图
marble	n.大理石
march	vi./n.前进，行进
margin	n.边缘；余地
marine	adj.海的，航海的，海产的
maritime	adj.海上的，海事的
markedly	adv.显著地，明显地
marsh	n.湿地，沼泽
marshy	adj.沼泽般的，湿软的
marvel	n.奇异的事物，罕见的例子
marvelous	adj.不可思议的；了不起的
mask	n.面具 v.掩盖，掩饰
mason	n.泥瓦匠
masonry	n.石工术；石匠职业
massive	adj.大而重的，庞大的；可观的
masterpiece	n.杰作，名著
matching	adj.(尤指颜色或外表)相配的,一致的
matchless	adj.无敌的；无比的
matchstick	n.火柴杆
mate	v.结伴，成配偶 n.配偶
mathematics	n.数学
maverick	adj.特立独行的；不遵守传统的 n.持异议者，自行其是者
meager	adj.缺乏的，不足的
meaningful	adj.意味深长的
measures	n.措施，方法
mechanical	adj.机械的；机械性的，呆板的
mechanics	n.机械学，力学
mechanism	n.机械；机理，运作机制
mechanized	adj.机械化的
media	n.媒体
mediate	v.斡旋，调停
mediator	n.调停者
medieval	adj.中世纪的
medium	n.媒体，媒介；方法
melodic	adj.有旋律的, 调子美妙的
melodious	adj.旋律优美的，悦耳的
melodrama	n.音乐剧；情节剧
melody	n.悦耳的音调
membrane	n.膜，薄膜
memo	n.备忘录
memorable	adj.难忘的
memorandum	n.备忘录, 便笺
memorial	n.纪念物
memorize	vt.纪念
memory	n.记忆，记忆力；回忆
menace	n.危险物 vt.威吓；胁迫
mend	vt.修补；改进
mention	vt.提及；说起
menu	n.菜单；选择单
mercantile	adj.商业的，贸易的
merchandise	n.商品
merchant	n.商人
merge	v.（使）合并，（使）融合
merger	n.合并
meridian	n.子午线
merit	n.优点，价值
mesmerize	vt.施催眠术；使入迷，迷住
messy	adj.肮脏的；凌乱的
metabolic	adj.新陈代谢的
metabolism	n.新陈代谢
metaphor	n.隐喻，暗喻
meteor	n.流星
meteorite	n.陨星，陨石
meteorologist	n.气象学者
meteorology	n.气象学
methodically	adv.有条理地；井然地
methodology	n.方法论，方法学
meticulous	adj.一丝不苟的，过细的
metropolitan	adj.主要都市的，大城市的
microbe	n.微生物
microcosm	n.微观世界
microorganism	n.微生物
microscope	n.显微镜
microscopic	adj.用显微镜可见的；极小的
microwave	n.微波（炉）
mighty	adj.强大的，巨大的
migrant	n.候鸟；移民
migrate	vi.移动，迁徙
migration	n.定期迁移；迁居
migratory	adj.迁移的；流浪的
milestone	n.里程碑；划时代的事件
milieu	n.环境；出身背景
militant	adj.好战的，好暴力的
millennia	n.一千年，千禧年
millionaire	n.百万富翁
mime	vt.模拟，模仿
mimetic	adj.模仿的，（生物）拟态的
mimic	n./vt.模仿，摹拟
mimicry	n.（生物）拟态；模仿
mingle	v.（使）混合
mingling	adj.混合的
miniature	adj.微型的，缩小的 n.缩小的模型，缩图，缩影
minimal	adj.最小的，最少的
minimalist	n.最低限要求者
minimize	v.最小化，减到最小
minimum	adj.最小的，最低的 n.最小值，最小化
minority	n.少数；少数民族
minuscule	adj.极小的
minute	adj.微小的
miracle	n.奇迹，奇事
miraculous	adj.奇迹的，不可思议的
mirage	n.海市蜃楼；幻想
misconception	n.误解
miserable	adj.痛苦的，悲惨的，可怜的
misfortune	n.不幸，灾祸
mislead	vt.使误入歧途，误导
misleading	adj.使人误解的；骗人的
mistrust	vt.不信任，不相信，怀疑
mitigate	vt.使减轻，使缓和
moat	n.护城河，壕沟
mobile	adj.可移动的 adj.易变的
mobility	n.流动性；灵活性
mock	v.（模仿性的）嘲笑
mockingbird	n.（动物）仿声鸟
moderate	adj.温和的；适度的，有节制的 vt.使缓和，使稳定
modest	adj.谦虚的；适度的
modify	vt.修改，变更
moist	adj.潮湿的，多雨的
moisten	vt.弄湿，使湿润
moisture	n.潮湿，湿气；湿度
mold	vt.塑造 n.模子；铸型 n.霉菌
molecular	adj.分子的
molecule	n.分子
molten	adj.熔融的，熔化的
monarch	n.君主，帝王
monetary	adj.货币的，金钱的
monitor	vt.监控；监测
monochromatic	adj.单色的，一色的
monopolize	vt.独占，垄断
monopoly	n.独占，垄断
monotonous	adj.单调乏味的，无变化的
monster	n.怪物，巨兽
monument	n.纪念碑；纪念物
morale	n.士气
morphololgy	n.形态学，形态论
mortal	n.凡人，人类 adj.必死的；致命的
mortar	n.灰泥；臼, 研钵
motif	n.（作品）主题，主旨
motion	n.运动
motionless	adj.不动的，静止的
motivate	vt.激发，刺激
motivation	n.动机，刺激
motive	n.动机
mounmental	adj.杰出的，不朽的
mournful	adj.悲痛的，悲哀的
mourning	n.悲恸，服丧
mouth	n.入口
mulberry	n.桑树
multi-faceted	adj.多方面的；多才多艺的
multicellular	adj.多细胞的
multifaceted	adj.多层面的
multiple	adj.多样的，多重的 n.倍数
multiply	v.繁殖，增加 v.乘（by）
multistory	n.多层建筑
multitude	n.大量，多数
mundane	adj.世俗的，平凡的 adj.平常的，普通的
municipal	adj.市的，市政的
mural	n.壁画，壁饰
muscular	adj.强壮的，肌肉发达的
mushroom	n.蘑菇 v.迅速生长
mutual	adj.相互的；共有的
myriad	n.许多，无数 adj.无数的
mysterious	adj.神秘的
myth	n.神话，神话故事
mythical	adj.神话的，虚构的
mythology	n.（总称）神话
naked	adj.裸体的，无遮盖的
narcotic	adj.麻醉的，催眠的；n. 麻醉剂
narrator	n.讲述者
naturalist	n.自然主义者，博物学着
naturalistic	adj.自然（主义）的
naval	adj.海军的；军舰的
navigate	vi.航行，航海；航空
navigation	n.航海
neat	adj.整洁的；整齐的
needy	adj.贫穷的，生活艰辛的
negate	vt.否定，打消
negative	adj.否定的；消极的；负的
neglect	n./vt.疏忽；忘记
negligent	adj.疏忽的，粗心大意的
negligible	adj.可忽略的，无关紧要的
negotiation	n.商议，谈判
neoclassical	adj.新古典主义的
neon	n.[化]氖；霓虹灯
nervous	adj.神经的；神经紧张的，易激动的
neuron	n.神经元，神经细胞
neurotransmitter	n.[生化]神经传递素
neutral	adj.中性的；中立的
neutralize	vt.抵消，中和
neutron	n.中子
newscast	n.新闻广播
newsstand	n.报摊，杂志摊
niche	n.壁龛 n.适当的位置；称心的职务
nickel	n.镍；镍币
nicotine	n.尼古丁
nocturnal	adj.夜的, 夜曲的
noisy	adj.嘈杂的
nomadic	adj.游牧的，流浪的
nominate	vt.提名；任命
nominee	n.被提名的人, 被任命者
nonconformist	adj./n.不遵照传统生活的（人）
nonconformity	n.不墨守陈规，不一致
nonetheless	adv.虽然如此，但是
nonfiction	n.非小说的散文文学
nonhuman	adj.非人类的
nonprofessional	adj./n.非专业的(人员)；无专长的(人员)
nonrelevant	adj.非关联的，非相关的
nonsense	n.胡说，废话
nontraditional	adj不遵照传统生活的
nonverbal	adj.不用语言的
nonviolence	n.非暴力
norm	n.标准，规范
normal	adj.正常的，标准的
normally	adv.通常地
nostalgia	n.思家病，怀旧
notable	adj.著名的；显要的 n.名人，要人
notably	adv.显著地；特别地
notate	vt.以符号表示，把…写成记号
notation	n.符号
notch	n.刻痕
note	n.音符
notorious	adj.臭名昭著的，声名狼藉的
notoriously	adv.声名狼藉地
nourish	vt.养育；滋养
nourishing	adj.有营养的；滋养的
nourishment	n.营养品
novel	adj.新奇的，新颖的
novelty	n.新颖，新奇
novice	n.生手，新手
nowadays	adv.现今，时下
noxious	adj.有害的，有毒的
nuclear	adj.核子的；核的，原子能的
nuclei	n.核子；核心
nucleus	n.合子，核心
null	adj.无效的；空的
numerous	adj.众多的，很多的
nutrient	n.营养物
nutritional	adj.营养的, 滋养的
nutritious	adj.有营养成分的, 营养的
oath	n.誓言，宣誓
objection	n.反对
objective	n.目标 adj.客观的
obligated	adj.有义务的，有责任的
obligation	n.义务，职责
obligatory	adj.强制性的，义务的
oblige	vt.迫使，责成
obliterate	vt.涂掉，擦掉
obscure	vt.隐藏，使…模糊 adj.朦胧的，模糊的；晦涩的
obsessed	adj.心神不宁的,鬼迷心窍的,沉迷的
obsession	n.入迷；固执的念头
obsolete	adj.废弃的；过时的
obstacle	n.障碍
obstruct	vt.阻塞(道路、通道等)；妨碍,阻挠
obstruction	n.阻塞，妨碍；障碍物
obtain	vt.得到
obtainable	adj.可得到的
occasional	adj.偶然的；临时的
occasionally	adv.偶尔
occupant	n.占有者，居住者
occupation	n.职业
occupy	vt.居住 vt.占用，占据
occur	vi.发生，出现 vi.想到
occurrence	n.事件；发生
octopus	n.章鱼
odd	adj.奇异的，古怪的
oddly	adv.奇特地，古怪地
odds	n.可能的机会, 成败的可能性, 几率
odor	n.气味
odorless	adj.无嗅的，没有气味的
offensive	adj.讨厌的，无礼的；攻击性的
offshore	adj.离岸的, 海面上的
offspring	n.(单复数同形)子孙, 后代
olfactory	adj.嗅觉的
omit	vt.省略，省去，忽略
ongoing	adj.正在进行的
onset	n.开始 n.（病）发作
onslaught	n.冲击；猛攻
ooze	n.软泥 v.渗出，泄漏
opaque	adj.不透明的；晦涩难懂的
opera	n.歌剧
opponent	n.对手，敌手，反对者
opportunity	n.机会，时机
opposed	adj.反对的
opposing	adj相反的，对立的
opposite	n.相反的事物 adj.相反的，对立的
opposition	n.反对，敌对
optical	adj.视觉的；光学的
optimal	adj.最佳的，最理想的
optimist	n.乐观者
optimistic	adj.乐观的
optimum	adj.最适宜的
option	n.选项，选择权
optional	adj.可自由选择的
optometrist	n.验光师
oral	adj.口头的
oratorio	n.宗教剧
orbit	n.轨道 vt.绕…轨道而行
orbital	adj.轨道的
orchard	n.果园
orchestra	n.管弦乐队
orchid	n.兰花
ordeal	n.严峻考验，痛苦经历
ordinance	n.法令，条例
ore	n.矿石
organic	adj.（化学）有机的
organically	adv.器官上地, 有机地,有组织地
organism	n.生物，有机物
orient	vt.使适应；确定方向
oriental	adj.亚洲的，东方的
orientation	n.定向；介绍性指导
original	adj.最初的，原始的 adj.有创意的
originality	n.创意，新奇
originate	vt.发生；发起，创办
ornament	n.装饰；装饰物
ornamental	adj.装饰的
ornamentation	n.装饰；装饰品
osprey	n.鱼鹰
ounce	n.盎司
oust	vt.驱逐；赶走
outbreak	n.发作；爆发
outcome	n.成果，后果
outcry	n.大声疾呼；强烈抗议
outdated	adj.过时的
outdoors	adv.在户外，在野外
outermost	adj.最外面的，离中心最远的
outfit	n.服装 vt.配备，装备
outgoing	adj.好交际的，外向的
outgrow	vt.生长速度超过…，长得比…快
outgrowth	n.长出；结果；副产物
outlast	vt.比…长久，比…活得长
outlet	n.（河流、烟等）出口
outlook	n.观点，见解 n.前景
outlying	adj.边远的，偏僻的
outmoded	adj.不再流行的，过时的
output	n.输出，产品；生产量
outrage	vt.凌辱，引起…义愤
outright	adv.彻底地，完全地
outset	n.开始，开端
outspoken	adj.坦率直言的
outstanding	adj.杰出的，显著的
outweigh	vt.比…重；比…更重要
oval	adj.卵形的，椭圆的
overall	adj.全部的，全面的
overbalance	vi.失去平衡
overburden	v.装载过多；负担过多
overcast	adj.阴天的，阴暗的
overcharge	v.索价过高
overconfident	adj.过于自信的，自负的
overdue	adj.迟到的；逾期的
overestimate	vt.评价过高
overhaul	v.彻底检查，大修
overlap	vt.部分重叠，与…交搭，迭盖
overlapping	adj./n.交迭（的）
overload	vt.使超载，使超过负荷
overlook	vt.忽略，没注意到 vt.俯瞰，远眺
oversecretion	n.分泌过多
oversee	vt.监督，管理
oversight	n.勘漏, 失察, 疏忽
overt	adj.明显的；公然的
overtax	vt.课税过重
overtaxed	adj.课税过重的，负担过重的
overtime	n.超时，加班    adv.  加班地
overtire	vt.使过度疲劳
overturn	n./vt.推翻；翻倒；倾覆
overwhelm	vt.战胜；压倒 vt.泛滥；使沉浸
overwhelmingly	adv.压倒性地；不可抵抗地
oxen	n.（pl）公牛
oxygen	n.氧气
oyster	n.[动]牡蛎, 蚝
ozone	n.[化]臭氧
pack	vt.装；将…挤入，塞满 n.一群
package	n.包裹，包
packaging	n.包装
packed	adj.压紧的，压实的
packer	n.包装工人，打包机
paddler	n.划独木舟者
painstaking	adj.辛苦的，辛勤的
painting	n.绘画，油画
palatable	adj.美味的
pale	adj.苍白的；暗淡的
paleontologist	n.古生物学者
palette	n.调色板，颜料
pamphlet	n.小册子
pane	n.窗格玻璃
panel	n.镶板 n.专门小组 vt.镶嵌（板）
panic	n.恐慌
pants	n.裤子；短裤
parachute	n.降落伞
parade	n.游行
parallel	vt.与…平行；匹敌 n.类似，相似 adj.平行的
paralysis	n.瘫痪，中风
paralyze	vt.使瘫痪，使麻痹
parameter	n.参数，参量
paramount	adj.最重要的；最高权力的
paraphrase	vt.将…释义，改写 n.释义，意义
parapsychology	n.超心理学
parasite	n.寄生虫，食客
parasitic	adj.寄生的
parliamentary	adj.议会（制）的
partial	adj.部分的
participant	n.参与者，参赛者
particle	n.颗粒，微粒
particulate	adj.微小的
passion	n.激情，热情
passionate	adj.充满热情的，热烈的
passive	adj.被动的；消极的
pastel	adj.柔和的
pasture	n.牧场，草地
patch	n.片，块
patent	n.专利 vt.取得…的专利权，申请专利
path	n.轨道，道路
pathogen	n.病菌，病原体
pathway	n.路，径
patriarch	n.家长，族长
patriarchal	adj.家长的，族长的
patriot	n.爱国者
patriotic	adj.爱国的
patrol	v.巡逻，巡视
patroller	n.巡警
patron	n.赞助人，资助人 n.顾客
patronage	n.赞助；惠顾
patronizing	adj.俨然以恩人态度的, 要人领情的
paucity	n.小量，缺乏
pauper	n.贫民，乞丐
pave	vt.铺设，为…铺路
paycheck	n.付薪水的支票
peak	n.山顶；最高点，顶端
pebble	n.小圆石，小鹅卵石
peck	v.啄，啄起
peculiar	adj.特有的，专有的 adj.奇怪的，异常的
peculiarity	n.特性，怪癖
pedagogic	adj.教育学的
pedagogical	adj.教育学的，教学法的
pedagogy	n.教育学，教学法
peer	v.凝视，仔细看 n.同辈，同等的人
peerless	adj.出类拔萃的, 无可匹敌的
penal	adj.刑罚的，刑法上的
penalty	n.处罚，罚款
penchant	n.爱好，嗜好；（强烈的）倾向
pendant	n.垂饰；下垂物
penetrate	vt.穿透；渗透
penetrating	adj.（声音）响亮的，尖锐的 adj.（气味）刺激的 adj.（思想）敏锐的，有洞察力的
peninsula	n.半岛
pensive	adj.沉思的
perceive	vt.感知；察觉，发觉
perception	n.理解；感知，感觉
perceptive	adj.感知的；有洞察力的
perch	n.栖木  v. （使）栖息
percolate	v.过滤，渗透   n. 滤液
percussion	n.打击乐器；震荡，影响
perennial	adj.四季不断的，终年的；（植物）多年生的
perennially	adv.永久地，终年地
perfect	adj.完美的，理想的 vt.使完美；使熟练
perfection	n.尽善尽美，完美
perform	vt.履行，执行 vt.表演，演出
performance	n.履行，执行；表演，演奏
performer	n.表演者
perfume	n.香味；香水
perimeter	n.边缘，周边地带
period	n.时期；时代
periodic	adj.周期的, 定期的
periodical	n.期刊，杂志 adj.周期的，定期的
peripheral	adj.周边的，外围的
periphery	n.外围
perishable	adj.（尤指食物）易腐的，易坏的
permanent	adj.长久的，永久的
permeable	adj.有浸透性的，能透过的
permeate	vt.弥漫；渗透，透过
permission	n.许可，允许
permissive	adj.许可的，宽容的
perpendicular	adj.垂直的，直立的
perpetuate	vt.使…延续，使永存
perplex	vt.迷惑，困惑；难住
perplexing	adj.使人困惑的；令人费解的
perseverance	n.坚定不移
persevere	vi.坚持不懈，不屈不挠
persist	vi.坚持；持续
persistence	n.坚持不懈，持续
persistent	adj.坚持不懈的
personality	n.个性，性格
personnel	n.人员，职员
perspective	n.(判断事物的)角度，方法，观点 n.透视；远景
perspiration	n.汗水；出汗
perspire	vi.出汗
persuade	v.说服，劝说，（使）相信
persuasive	adj.有说服力的，善说服的
pertinent	adj.相关的，切题的；中肯的
pest	n.害虫；令人讨厌的人或物
pesticide	n.杀虫剂
pestilence	n.瘟疫
pestilential	adj.引起瘟疫的
pet	n.宠物
petal	n.花瓣
petition	n./v.请愿
petrifaction	n.石化, 化石
petroleum	n.石油
phase	n.阶段，态
phenomena	n.（pl）现象
phenomenally	adv.明白地，显著地
philharmonic	n.交响乐团
philology	n.语言学，文献学
philosophy	n.哲学；原理，人生观
phonetics	n.语音学
photograph	n.照片
photosensitive	adj.[物] 感光性的
photosphere	n.光球
photosynthesis	n.光合作用
physiological	adj.生理学的；生理上的
physiology	n.生理学
picturesque	adj.如画的，美丽的
pierce	vt.穿透，戳穿
pigment	n.色素，颜料
pill	n.药丸
pillar	n.柱，柱子
pillow	n.枕头
pinch	vt.掐，夹痛
pine	n.松树 vi.憔悴，消瘦
pineapple	n.凤梨, 菠萝
pinpoint	vt.准确地确定；用针标出…的精确位置
pioneer	n.开拓者 v.开辟，倡导
pioneering	adj.开创性的
pique	vt.激起，引起（好奇等） vt.激怒
pit	n.坑，地坑；煤矿 vt.使对抗，使相斗
pitch	n.音高
pitcher	n.大水罐，水壶
pivot	n.枢轴；中心点，重点
pivotal	adj.枢轴的，关键的
plagiarism	n.剽窃，抄袭
plague	n.瘟疫，灾祸 vt.折磨，使苦恼
plain	n.平原，草原 adj.简单的，朴素的
plainly	adv.清楚地，明显地
plainspoken	adj.直言不讳的
planet	n.行星
plank	n.厚木板
plantation	n.种植园
plasma	n.血浆
plaster	n.灰泥，石膏 vt.抹泥，涂
plate	n.盘子；版图；大片平面
plateau	n.高原，高地
platelike	adj.层状的
platform	n.月台，平台，讲坛
platitude	n.陈词滥调
platitudinous	adj.陈词滥调的，陈腐的
playwright	n.剧作家
pleasing	adj.令人高兴的, 愉快的, 合意的
pleasure	n.快乐
pledge	n.保证，誓言 vt.发誓；保证
pliable	adj.易弯的，柔软的 adj.易受影响的；柔顺的
pliant	adj.顺从的；可弯曲的
plight	n.（恶劣的）情势，困境
ploished	adj.擦亮的
plow	n.犁 vt.耕作
plumage	n.鸟类羽毛
plumb	adj.垂直的
plumber	n.水管工人
plumbing	n.（供水）管道系统
plump	adj.胖嘟嘟的，丰满的
plunge	vi.跳进；投入，陷入
pocketbook	n.钱袋，皮夹
polarize	vt.使极化，使两极分化
pole	n.（南北）极；磁极，电极
polish	vt.擦亮 n.光泽；上光剂
politics	n.政治；政见；政治学
poll	n.选举之投票；民意测验
pollen	n.花粉
pollinate	vt.对…授粉
pollination	n.授粉
pollinator	n.传粉媒介，传粉昆虫
pollutant	n.污染物质
pollute	vt.污染；玷污
pollution	n.污染；玷污
polygon	n.多边形
polygonal	adj.多角形的，多边形的
popcorn	n.爆米花
popular	adj.流行的，受欢迎的
popularity	n.流行，受大众欢迎
populous	adj.人口稠密的，人口多的
porcelain	n.瓷器, 瓷
porcupine	n.[动]豪猪, 箭猪
pore	n.小孔，气孔
porous	adj.可渗透的，多孔的
portable	adj.编携的，手提的；轻便的
portend	vt.预兆，预示
portion	n.一部分；部分
portrait	n.肖像，人像
portraitist	n.肖像画家
portraiture	n.肖像画法
portray	vt.描述；绘制
portrayal	n.饰演；描画
pose	vt.形成，引起 n.姿势，姿态
positive	adj.（电）阳极的 adj.肯定的；积极的
possess	vt.拥有，占有
possession	n.拥有，占有；财产
post	vt.张贴，揭示 n.柱；邮件
postage	n.邮资
postal	adj.邮政的，邮局的
postcard	n.明信片
postdate	vt.填迟…的日期
poster	n.海报，招贴
postgraduate	n.研究生
posthumous	adj.死后的，身后的
postmaster	n.邮局局长
postoperative	adj.手术后的
postpone	vt.推迟，使延期
postulate	vt.要求；假定
posture	n.姿势，体态
postwar	adj.战后的
pot	n.罐，壶
potent	adj.强有力的，有效的
potential	adj.可能的；潜在的
potentiality	n.潜能，潜力
potted	adj.盆栽的；平或罐装的
potter	n.陶工，制陶工人
pottery	n.陶器，陶器场
pound	n.磅，英镑 vt.强烈打击
poverty	n.贫困
practicable	adj.行得通的，可以实行的
practical	adj.实际的，实践的；实用的
practicality	n.实用性
practically	adv.实际上；几乎，简直
prairie	n.大草原
preach	v.布道；鼓吹
precarious	adj.不稳定的；危险的
precaution	n.预防措施，警惕
precede	vt.在…之前，早于；优先于
precedent	n.先例
preceding	adj.在前的
precious	adj.宝贵的，珍贵的
precipitate	vt.促成；加速 vi.猛地落下 n.沉淀物，降雨
precipitation	n.仓促，降雨量
precipitous	adj.陡峭的
precision	n.精确，精密度
precursor	n.先驱，先行者；先兆
predator	n.食肉动物
predatory	adj.掠夺的；食肉的
predecessor	n.前辈，前任
predict	vt.预言，预告
predictability	n.可预言
predictable	adj.可预见的
prediction	n.预言，预报
predictive	adj.预言性的，成为先兆的
predominant	adj.支配的，主要的
predominantly	adv.主要地
predominate	vt.统治，成为主流
preeminent	adj.卓越的，出类拔萃的
prefabricated	adj.预制的
preferable	adj.更可取的，更好的
preference	n.偏爱；优先；优先权
pregnant	adj.怀孕的
prehistoric	adj.史前的
preliminary	adj.预备的，初步的
premature	adj.早熟的，不成熟的；过早的
premium	n.保险金；奖金 adj.高级的，高价的
preoccupation	n.主要考虑因素；全神贯注，抢先占据
preponderance	n.（数量或力量上的）优势
prerequisite	n.先决条件 adj.首要必备的
prescribe	vt.指示，规定 vt.开药方
prescribed	adj.规定的
prescription	n.药方，处方
presence	n.出席，到场
preservation	n.保存，贮藏；保护
preservative	n.防腐剂
preserve	vt.保护，保存
presidency	n.总统职位；总统任期
pressure	n.压力；压迫
prestige	n.威望，声望
prestigious	adj.有名望的，有威信的
presumably	adv.推测起来, 大概
pretense	n.矫饰，做作
pretension	n.主张，要求
prevail	vi.盛行，居主导地位
prevailing	adj.流行的，盛行的
prevalent	adj.普遍的；流行的
prey	n.被掠食者，牺牲者，食物 vi.捕食，掠夺
primal	adj.原始的；最初的 adj.最重要的
primary	adj.第一位的，主要的
primate	n.灵长目动物 adj.首要的，第一的
prime	adj.主要的 n.鼎盛时期
primitive	adj.上古的，原始的
primordial	adj.原始的，最初的
priority	n.优先，优先权
pristine	adj.原始的，未被破坏的
privilege	vt.给与…特权，特免   n. 特权
probe	vi.调查，查究
proceed	vi.进行，继续下去
proceeding	n.行动；进行
proceeds	n.（pl）收益
process	n.过程；   vt. 加工
proclaim	vt.声明，宣告
proclivity	n.倾向，癖性
prod	vt.戳，刺 vt.刺激，激励
prodigious	adj.巨大的，惊人的；挥霍的
prodigy	n.非凡之人，天才
produce	v.生产     n. 农副产品
profession	n.职业，专业
professional	adj.专业的，职业的
professionalism	n.专家的地位,特性或方法, 专业主义
proficiency	n.熟练，精通
proficient	adj.熟练的，精通的
profile	n.剖面，侧面；轮廓
profound	adj.深刻的，深奥的
profoundly	adv.深深地，衷心地
progress	n./vi.前进，发展
progression	n.行进；次序
progressive	adj.前进的；累进的
prohibit	vt.禁止
prohibitive	adj.禁止的，抑制的
prohibitively	adv.令人望而却步地；(价格)极高地
project	n.设计，规划；项目
projecting	adj.突出的，伸出的
projection	n.发射
projectionist	n.电影放映员，幻灯放映员
projector	n.放映机
proliferate	vi.激增；繁殖
proliferation	n.繁殖，大量增殖
prolific	adj.多产的，多结果的
prolong	vt.拖长，延长
prominence	n.显著，突出
prominent	adj.杰出的，突出的
promising	adj.有前途的，有希望的
promote	vt.晋级，使升级；促进
promoter	n.促进者
prompt	vt.鼓动，促进 adj.迅速的；按时地
prone	adj.易于…的；倾向于…的
pronghorn	n.(墨西哥和美国西部产的)叉角羚
pronounced	adj.显著的，明确地
proof	n.证据
proofread	vt.校正，校对
propagate	vt.繁殖 vt.散布，传播
propel	vt.推进，促进
propellant	n.推进物
propensity	n.倾向，癖好
proper	adj.恰当的，得体的
property	n.财产，所有物；性质，特性；（小）道具[pl]
propery	n.财产，所有权
proponent	n.支持者，拥护者
proportion	n.比例，比率
proposal	n.提案；建议
propose	vt.提出，提议
proprietor	n.所有者，业主
proprietorship	n.所有权
propulsion	n.推进；推进力
prose	n.散文
prosecute	vt.对…起诉；告发
prospect	n.前景，期望 vt.勘探，采矿
prospecting	n.探矿
prospector	n.勘探者，采矿者
prosper	vi.繁荣，成功
prosperity	n.繁荣，兴旺
prosperous	adj.成功的，繁荣的
protagonist	n.领导者 n.(戏剧, 故事, 小说中的)主角
protectionist	n.贸易保护主义者
protein	n.蛋白质
protest	n./v.抗议
prototype	n.原型
prototypical	adj.原型的
protruding	adj.突出的
provincialism	n.地方主义，心胸狭窄
provision	n.供应；（一批）供应品；规定
provocation	n.激怒，挑拨，刺激
provocative	adj.挑拨的；煽动的
provoke	vt.激怒，惹起
prudent	adj.审慎的，深谋远虑的
psychoanalysis	n.心理分析
psychology	n.心理学；心理
publicity	n.公开，宣传
publicize	vt.（公开）宣传，宣扬
puddle	n.小水洼
pueblo	n.印第安人村庄
pulp	n.果肉
pulse	n.脉搏，脉冲
pump	n.泵 vt.（用泵）抽，抽吸
pumpkin	n.南瓜
punch	vt.重击 vt.打（孔）
puncture	vt.刺穿，戳破
pungent	adj.（气味、味道）刺激性的，辛辣的；尖锐的
pupil	n.瞳孔
purification	n.纯化，净化
purified	adj.纯净的
purify	vt.提炼，精炼
purple	n.紫色
pursue	vt.追赶，追踪；从事
puzzle	n.难题，谜 v.（使）困惑，为难
puzzling	adj.使迷惑的，使莫名其妙的
pyramid	n.金字塔
quadrilateral	四边形
quail	n.鹌鹑
quaint	adj.奇怪的，离奇有趣的
qualification	n.资格，条件
qualified	adj.合格的
quantitative	adj.定量的；数量的
quarry	n.采石场，露天矿场
quarter	n.四分之一
quarterly	adv.每季地
quartz	n.石英
quench	vt.淬火 vt.熄灭 vt.解渴
quest	n.寻找，探索
questionable	adj.可疑的
questionnaire	n.调查表, 问卷
quiescent	adj.静止的
quilt	n.棉被 vt.制成棉被
quilter	n.缝被子的人
quota	n.配额；定量，定额
quotation	n.引用语
radar	n.雷达
radiant	adj.发光的；荣光焕发的
radiate	v.放射；辐射
radiation	n.辐射，发光，放热
radical	adj.根本的；激进的
radically	adv.根本上
raft	n.筏，救生艇
rage	n.风尚，风靡一时的事物 n.大怒，情绪激动
ragged	adj.褴褛的，破烂的
ragtime	n.拉格泰姆音乐
raid	n.袭击
rainbow	n.彩虹
rainfall	n.降雨；降雨量
rally	v.召集，集合
rampant	adj.蔓生的，猖獗的
ranch	n.农场，牧场
rancher	n.大农场经营者；牧场工人
ranching	adj.放牧的
range	n.行列；范围
rank	vt.排列，归类 n.等级
rare	adj.稀有的
rarefy	vt.使稀少，使稀薄
rarely	adv.很少地，罕有地
ratify	vt.批准
ration	n.定量，配给量 vt.定量配给
rational	adj.理性的，合理的
rationing	n.（食物等的）配给
rattle	n.拨浪鼓；格格声
rattlesnake	n.响尾蛇
raucous	adj.沙哑的；喧嚣的
raven	n.大乌鸦 v./n.掠夺
ravine	n.沟壑，峡谷
rawhide	n.生牛皮
ray	n.光线
rayon	n.人造丝, 人造纤维
raze	vt.夷为平地
readily	adv.容易地；欣然地，立刻地
readjust	vt.重新调整
realization	n.实现；意识
realm	n.王国，领域
reap	vt.收割，收获
rear	vt.培养，饲养 n.后面
reassure	vt.使...安心，打消...疑虑
rebel	n.叛徒 v.谋反
rebellion	n.谋反，叛乱
rebellious	adj.造反的，反叛的
rebroadcast	vt.重播
rebuke	vt.斥责，谴责
recall	vt.忆起，记忆
receptacle	n.容器；贮藏所，仓库
reception	n.接待；招待会 n.接收
receptionist	n.招待员
receptive	adj.善于接受的，能接纳的
receptor	n.接受器，感受器
recession	n.萧条时期，（经济）衰退
recipe	n.食谱，处方
recipient	n.接受者，接收方
recital	n.独奏会
reckless	n.轻率的，鲁莽的
reckon	vt.计算；估计，猜想
reclaim	vt.开垦；要求归还，收回
reclamation	n.开垦；改造；（废料等的）回收
recognition	n.赞誉，承认
recognize	vt.识别，辨认 vt.公认，赏识
recoil	vi.弹回，反冲
recollection	n.回忆，记忆
recommend	vt.推荐 vt.劝告
recommendation	n.推荐，介绍（信）
recompose	vt.重写；重新安排
reconstruct	vt.重建，改进
reconstruction	n.复兴，改造，再建
recount	vt.叙述，描写
recreation	n.消遣，娱乐
recreational	adj.娱乐的
recruit	vt.征兵，征募；补充
rectangle	n.长方形
rectangular	adj.矩形的，长方形的
rectify	vt.矫正
recur	vi.重现，再来；复发
recurring	adj.往复的，再次发生的
recycle	vt.使再循环，再利用
redirect	v.（信件）重寄；使改变方向
reed	n.芦苇
reef	n.礁，暗礁
refine	vt.精炼，精制
refined	adj.优雅的；精制的
refinement	n.（言语、举止等的）文雅，精巧
reflection	n.反映
reform	n./v.改革，革新
reformer	n.改革家，改革运动者
reformism	n.改革主义
refraction	n.折光，折射
refreshing	adj.提神的,凉爽的;使人耳目一新的
refreshment	n.茶点；提神之事物
refrigerant	n.制冷剂
refrigerate	vt.使冷却，冷藏
refrigeration	n.冷藏，冷却
refrigerator	n.冰箱，冷藏库
refurbish	vt.刷新，再磨光
refute	vt.反驳
regardless	adj.不管，不顾，不注意
regenerate	vt.使再生，新生；更新
regeneration	n.（灵魂）重生，新生
regime	n.政权，政体；政治制度
regimentation	n.系统化，组织化；团队精神
register	vt.登记
regulate	vt.管制，控制 vt.调节
regulation	n.规则，规章
regulatory	adj.按规矩来的，规章的，调节的
rehabilitate	vt.使(身体)康复；使复职；使复元
rehabilitation	n.恢复，复员
rehearse	vt.预演，排练
reign	n./vi.统治，支配
reigning	adj.统治的，起支配作用的
reimburse	vt.偿还
reinforce	vt.加强
reinterpretation	n.重新解释，纠正性说明
reiterate	vt.重申，反复地说
reject	vt.拒绝，抵制
rejection	n.拒绝
rejuvenate	v.(使)返老还童；(使)恢复活力
rekindle	vt.再点火；使再振作
relax	v.（使）松弛，放松
relaxation	n.松弛，缓和
relaxed	adj.不拘束的；悠闲的
relay	vt.分程传递；传播
release	v./n.释放
relevance	n.相关
relevant	adj.有关的，切题的
reliability	n.可靠性
reliable	adj.可靠的，可信赖的
reliance	n.依靠；依靠的人或物
reliant	adj.依靠的，信赖自己的
relic	n.遗迹，纪念物
relieve	vt.减轻
relieved	adj.放心的；免除的
religion	n.宗教
religious	adj.信奉宗教的，虔诚的
reluctant	adj.不情愿的，勉强的
remainder	n.残余，剩余物
remaining	n.剩余，残余
remark	n.评论，注释 v.评论；谈及
remarkable	adj.显著的，值得注意的
remarkably	adv.显著地，引人注目地
remedy	n.药物 vt.治疗；补救
remind	vt.提醒，使记得
reminder	n.提醒者
remnant	n.残余，遗迹
renaissance	n.复活；文艺复兴
render	vt.给予，提供
rendering	n.表现，描写
rendition	n.表演，演唱
renew	vt.使更新，使恢复；重新开始
renewable	adj.可更新的，可恢复的
renewal	n.更新；复兴
renounce	vt.声明放弃；宣布断绝关系
renovate	vt.革新；修理，修复
renovation	n.修复，整修 n.革新；修理，修复
rent	n.租金，租费 v.租，出租 adj.(来自rend的过去分词)分裂的，有矛盾的
rentable	adj.可出租的
rental	n.租金额；租赁，出租
renunciation	n.放弃；宣布终止
reorient	v.重新确定方向；再教育
repel	vt.击退，驱逐
repertoire	n.（剧团等）常备剧目，保留剧目
repertory	n.全部剧目；储备，库存；仓库
repetition	n.重复
replace	vt.代替，取代
replenish	vt.补充，把…再备足
replica	n.复制品
replicate	vi.复制
represent	vt.代表；描绘，表现
representation	n.表示，表现
representative	n.代表 adj.典型的，有代表的
repress	vt.抑制，镇压
reproduce	v.繁殖，再生；复制
reproduction	n.复制品；繁殖
reproductive	adj.生殖的
reptile	n.爬行动物
repulse	vt.击退 vt.拒绝，排斥；憎恶
repute	n.名声
reputed	adj.名誉好的，被称为…的，有…名气的
request	v./n.请求，要求
reschedule	v.重新计划, 重订...的时间表
rescue	vt.援救，救援
resemblance	n.相似，酷肖
resemble	vt.像，类似
resent	vt.愤怒，怨恨
resentful	adj.忿恨的，怨恨的
reserve	vt.储备；保留，预定
reservoir	n.水库, 蓄水池
reside	vi.居住
residence	n.居住，住处
resident	n.居民
residential	adj.住宅的，与居住有关的
residual	adj.剩余的，残留的
residue	n.剩余，残余，渣滓
resist	vt.抵抗 vt.不受…影响，抗，耐
resistance	n.反抗，抵抗；抵抗力，阻力
resistant	adj.抵抗的，有抵抗力的
resolute	adj.坚决的，毅然的
resolution	n.分辨率
resolve	vt.解决
resonance	n.回声，反响
resort	n.旅游胜地 n./v.凭借，求助于
resource	n.资源，财力；办法，智谋
respect	n./v.尊敬，敬重 n.方面
respective	adj.分别的，各自的
respectively	adv.分别地，各个地
respiration	n.呼吸
respiratory	adj.呼吸的
respond	vi.回答，反应
responsibility	n.责任，职责
responsible	adj.有责任的 adj.负责的；可依赖的
responsive	adj.响应的，做出相应的
restoration	n.恢复；翻新
restore	vt.使恢复；整修，修复
restrain	vt.克制，抑制
restraint	n.抑制，克制
restrict	vt.限制，约束
restriction	n.限制，约束
restrictive	adj.限制性的
retail	adj.零售的
retailer	n.零售商
retain	vt.保持，保留
retentive	vt.保留的，有记忆的
retire	vi.退休，引退
retirement	n.退休
retool	vt.将机械重新整备，重组
retract	vt.缩回，撤回 vt.收回，取消
retreat	n.消退，退却 n.隐退处 vi.撤退，退却
retrieve	v.重新找回，取回；找回猎物
retriever	n.能把猎物找回来的猎狗的一种
retrospect	n.反顾，回顾
retrospective	adj.回顾的，怀旧的
reveal	vt.展现；揭露
revere	vt.尊崇，尊敬
revered	adj.可敬的，尊敬的
reverently	adv.虔诚地
reverse	adj.相反的,倒转的     vt. 颠倒,倒转
reversible	adj.可逆的，可翻转的
revise	vt.修改，修订
revision	n.修订，修改
revitalization	n.新生,复兴
revival	n.复兴，复活
revive	vt.使复活；使振奋
revolt	n./v.反抗，起义，反叛
revolution	n.革命
revolutionary	adj.革命的
revolutionize	vt.大事改革；在…方面发动革命
rhetoric	n.修辞；修辞学
rhythm	n.节奏，韵律
rhythmic	adj.有节奏的，有韵律的
rhythmical	adj.有韵律的，有节奏的
ridge	n.脊，山脊
ridicule	v.嘲笑
ridiculous	adj.荒唐的，可笑的
rifle	n.来复枪，步枪
rift	n.裂缝；断裂，长峡谷
rigid	adj.坚硬的，不易弯曲的 adj.严格的
rigidity	n.僵化，死板 n.刚性，硬度
rigor	n.严酷；严格，严厉
rigorous	adj.严格的
rinse	v.用清水冲洗；漱
riot	n.暴动，骚乱
rip	vt.撕，撕裂
ripe	adj.熟的；成熟的
ripen	v.（使）成熟
risky	adj.危险的，冒险的
rite	n.仪式
ritual	n.典礼,宗教仪式；例行公事,常规 adj.典礼的，宗教仪式的
rival	vt.比得上，与…相匹敌 adj.竞争的 n.竞争者；匹敌者
rivalry	n.竞争；敌对状态
roam	vi.漫游，漫步
roar	n.吼，轰鸣
roast	vt.烤，烘
robust	adj.强壮的，健壮的
rod	n.杆；枝
rodent	n.啮齿类动物
roe	n.鱼卵
role	n.角色，任务
roll	v.滚动 n.（一）卷，卷形物
romote	adj.遥远的，偏僻的
roost	n.栖息处，鸟巢 v.栖息
rooster	n.公鸡
rotate	v.轮流 v.（使）旋转
rotation	n.旋转
rote	n.死记硬背，生搬硬套
rough	adj.粗糙的；不平的
roughly	adv.概略地；大致地
routine	n.常规，惯例 adj.常规的，日常的
routinely	adv.例行公事地
rubbery	adj.橡胶似的，有弹性的
rubble	n.（一堆）碎石，瓦砾
rudimentary	adj.基本的；初步的，发展未完全的
rugged	adj.高低不平的；崎岖的
ruin	v.破坏，毁灭
ruins	n.废墟，遗迹
rumble	v.发出低沉的隆隆声 n.隆隆声，辘辘行驶声
rupture	n./v.断裂，断绝
rural	adj.农村的，乡下的，田园的
rust	n.锈，生锈 n.（植物）患锈病
rustic	adj.乡村的，乡下风格的
rustproof	adj.不锈的
sac	n.（生物）囊，液囊
sack	n.袋，麻袋
sacred	adj.宗教的；祭祀的 adj.神圣的，不可冒犯的
saddle	n.鞍子，马鞍
saga	n.英雄传奇
sake	n.缘故；原因
salient	adj.显著的，突出的
saline	adj.含盐的，咸的
salinity	n.盐分，盐度
saliva	n.口水，唾液
saltiness	n.盐度
sample	n.范例，样品
sanctimonious	adj.假装神圣的，伪装虔诚的
sanction	n.制裁 n.批准，认可
sanctuary	n.避难所；动物保护区 n.圣所，圣殿
sandy	adj.沙的，多沙的
sanitary	adj.（有关）卫生的
sanitation	n.（公共、环境）卫生，卫生设施
sap	n.树液，汁液 v.使衰竭
sapphire	n.蓝宝石
sarcastic	adj.讽刺的，挖苦的
satire	n.讽刺；讽刺文学
satiric	adj.讽刺的，挖苦的
satirist	n.讽刺作家
satisfaction	n.满意，满足
satisfactory	adj.令人满意的，符合要求的
saturate	vt.浸透，使湿透
saturated	adj.渗透的, 饱和的
saucer	n.茶碟，垫盘
save	vt.拯救；保留 prep.除…之外
savings	n.储蓄，存款
scaffolding	n.脚手架
scale	vt.攀登 n.等级，刻度；规模 n.鱼鳞，鳞片
scaled	adj.有鳞状斑点的，有鳞的
scan	vt.扫描；细看，审视
scapegoat	n.替罪羊，代人受过的人
scarce	adj.缺乏的，稀有的，罕见的
scarcely	adv.几乎不，简直没有
scare	vt.惊吓，使受惊
scarlet	adj.猩红的，鲜红的
scatter	vt.使分散，扩散
scavenger	n.清道夫，食腐动物
scene	n.地点，现场；景色
scenery	n.风景，景色
scenic	adj.风景如画的
scent	n.气味；香味
schedule	n.时间表；计划表 vt.预定，安排
scheme	n.方案 n.阴谋
scholar	n.学者
scholarly	adj.学者气质的，学术的
scholarship	n.奖学金
scissors	n.剪刀
scope	n.范围，界限
score	n.分数，得分；刻痕，划痕 n.乐谱 v.记分
scotch	v.镇压，粉碎
scour	vt.冲刷，擦掉
scout	n.侦察；侦察员 vt.侦察
scramble	vt.搅乱，使混杂 v.攀爬
scrap	n.废料，残余物 vt.废弃，扔弃
scrape	n.刮，擦；擦痕 vi.刮掉，擦掉；vt. 刮，擦，擦伤
scraping	n.刮削下的碎屑
scratch	vt.搔，抓，擦 n.划痕
screen	n.屏幕 vt.甄别，审察；掩盖
screw	n.螺旋，螺钉 v.旋紧，拧紧
screwdriver	n.螺丝刀
scruple	n.踌躇；顾忌
scrupulously	adv.小心翼翼地
scuba	n.水中呼吸器
sculpt	vt.雕刻，造型
sculptor	n.雕刻家
sculptural	adj.雕刻的，雕刻般的
sculpture	n.雕塑；雕刻品
seabed	n.海底，海床
seam	n.接缝，缝合线
seamen	n.海员
seamount	n.海底山
seaport	n.海港，港口
seashore	n.海岸，海滨
seasonal	adj.季节的，季节性的
seasoning	n.调味品，调料
seaweed	n.海草，海藻
seclude	vt.使隔离，使孤立
seclusion	n.独处，隐居
secondary	adj.中级的 adj.次要的，伴随的
secret	n.秘密
secrete	vt.分泌；隐匿，使隐秘
secretin	n.分泌素
sect	n.宗派，教派
section	n.部分，节
sectional	adj.部分的，部门的
sector	n.扇形面；地区
secular	adj.世俗的，尘世的
secure	vt.使安全，保卫 vt.获得 adj.安全的；确定无疑的
securely	adv.安心地, 安全地
security	n.安全
sedentary	adj.（人或动物）土生的，不迁徙的 adj.（工作）坐着做的（不需运动）
sediment	n.沉积物，沉淀物
sedimentary	adj.沉积的，沉淀性的
seduce	vt.勾引，诱惑
seedling	n.秧苗, 树苗
seemingly	adv.表面上，似乎
segment	n.部分；片断
segregate	vt.分离，隔离
seismic	adj.地震的；由地震引起的
seismograph	n.地震仪
seismology	n.地震学
selection	n.选择, 挑选；选集, 精选品
self-sufficient	adj.自给自足的
semester	n.学期
semiarid	adj.雨量非常少的，半干旱的
semiliterate	n.半文盲，有初等文化者
semimolten	adj.半熔化的
senator	n.参议员
sensation	n.感觉，知觉
sensational	adj.极好的，绝妙的；引起轰动的
sensibility	n.敏感性，感性
sensible	adj.明智的，合理的 adj.可感觉到的，明显的
sensitive	adj.灵敏的 adj.敏感的，易受影响的
sensitivity	n.敏感
sensory	adj.感觉的，感官的
sentence	n./v.宣判
sentimental	adj.感伤性的, 感情脆弱的
sentimentalism	n.感情主意，感情用事
sentimentalize	v.伤感
sequence	n.序列；顺序
sequester	vt.使退隐，使隔绝
serene	adj.平静的，安详的
serious	adj.严肃的，认真的 adj.严重的
seriously	adv.认真地；庄重地
serrated	adj.锯齿状的
setting	n.背景，环境；装置
sewer	n.下水道；裁缝师
sewerage	n.排水系统
shade	n.阴，阴凉处；阴影 n.遮光物，帘
shaft	n.杆状物，轴
shallow	adj.浅的
sharpen	vt.消尖；使敏锐，使敏捷
sharply	adv.突然地，猛烈地
shatter	v.使粉碎，破碎
shear	v.剪，修剪，剪切 n.shears  剪刀
sheath	n.鞘，外壳
shed	vt.脱落，蜕 vt.流出；发散 n.棚，小屋
sheer	adj.陡峭的 adj.纯粹的，绝对的
shell	n.壳 vt.去壳，脱落
shellfish	n.贝，有壳的水生动物
shelter	n.掩蔽处；庇护所 vt.掩蔽
sheltered	adj.遮蔽的
shepherd	n.牧羊人；牧羊犬
shield	v.庇护，保护 n.盾；保护物
shift	v.移动，改变位置或方向 n.轮班 n.转移；改变
shifting	adj.变动的；运动的
shine	vi.照耀，发光
shingle	n. <美口>小招牌(尤指医生或律师挂的营业招牌)
shining	adj.发亮的，华丽的
shiny	adj.有光泽的，发光的
shipload	n.船货, 一船上的载货
shipment	n.装运；装载的货物
shipwreck	n.船只失事, 海难
shipwright	n.造船工人
shock	n.震动，震惊 vt.震惊，激怒
shocked	adj.震惊的，震撼的
shocking	adj.骇人听闻的
short-range	adj.近程的
shortcut	n.捷径
shot	n.照相，照片 n.开枪，射击
shrink	vi.收缩，缩小
shrinkage	n.收缩
shrivel	v.（使）枯萎
shrub	n.灌木；灌木丛
shuffle	vt.洗牌
shutter	n.百叶窗；快门
shuttle	n.梭子；往返汽车 v.穿梭往返
shy	adj.害羞的；胆小的
shyness	n.羞怯，胆怯
sick	adj.不舒服的，有病的；恶心的
sickness	n.疾病；呕吐
sidestep	v.横跨一步躲闪；回避(困难)
sideways	adv.向一旁，向侧面地
significance	n.意义，含义；重要性
significant	adj.有意义的；重要的，重大的
signify	vt.表示，意味
silica	n.硅石，硅土
silicate	n.[化]硅酸盐
silly	adj.愚蠢的；糊涂的；傻的
silt	n.淤泥
silversmith	n.银器匠
simplicity	n.简单；朴素
simulate	vt.模拟，模仿
simultaneous	adj.同时的, 同时发生的
sinuous	adj.蜿蜒的，迂回的
skeleton	n.骨架；纲要
skeptical	adj.怀疑的；多疑的
skepticism	n.怀疑
sketch	n.草图；素描 vt.打草稿；素描
skimp	v.节省，节俭；吝啬
skip	v.跳 v.逃过；遗漏
skull	n.头骨
skyrocket	vi.猛涨，突增
skyscraper	n.摩天大楼
slab	n.（四边形的厚物质）板，片
slander	n./v.诽谤
slash	vt.大量消减
slavish	adj.卑屈的；盲从的
slender	adj.苗条的；纤细的
slice	n.薄片；部分，份 vt.切成薄片，切下
slide	v.（使）滑动，（使）滑行 n.幻灯片；滑，滑动
slight	adj.轻微的；微小的，微不足道的
slightly	adv.些微地
slime	n.黏土；黏液
slimy	adj.黏糊糊的；（分泌）黏液的
slip	n.片，纸片 n.滑倒；事故 v.滑动；滑倒
slipper	n.拖鞋
slippery	adj.（物体表面）滑的，光滑的
sloop	n.单桅帆船
slope	n.斜坡，斜面
sloping	adj.倾斜的，有坡度的
sloth	n.树懒；怠惰，懒惰
slothful	adj.迟钝的，懒惰的
sluggish	adj.行动迟缓的；不活泼的
slum	n.贫民窟
slumber	n.睡眠
smart	adj.巧妙的，聪明的
smelting	n.冶炼
smog	n.烟雾
smoothly	adv.平稳地；顺利地
smother	vt.使窒息 vt.熄灭；覆盖
smuggle	vt.走私
snap	v.突然折断 v.突然抓住或握住
snippet	adj.小片，片段；摘录
snowdrift	n.随风飘飞的雪
snowflake	n.雪花
snug	adj.温暖舒适的
sociable	adj.好交际的，友善的
softwood	n.软木材
solar	adj.太阳的
solder	vt.焊接，焊在一起
soldier	n.军人，士兵
sole	adj.单独的，惟一的 n.鞋底
solely	adv.独自地，单独地
solemn	adj.严肃的；庄严的，隆重的
solicit	vt.恳求，乞求
solicitor	n.律师，法律顾问
solidarity	n.团结，团结一致
solidify	vt.使凝结，使团结，使巩固
solitary	adj.孤独的；独居的
solitude	n.孤独；独处
solo	n.独奏曲 adj.单独的
soloist	n.独奏者，独唱者
soluble	adj.可溶的，可溶解的
solution	n.解答，解决 n.溶液
somewhat	adv.稍微，有点
soothe	vt.使（某人情绪）平静，安慰；使（痛苦，疼痛）缓和或减轻
sophisticated	adj.(事物)复杂的；(人)久经事故的
sophistication	n.老练；精致复杂
sort	n./v.种类，分类
soundproof	vt.使隔音 adj.隔音的
sour	adj.酸的
souvenir	n.纪念品
sovereign	n.君主；统治 adj.独立自主的
sovereignty	n.主权，统治权
sow	vt.播种
soy	n.大豆
soybean	n.大豆
spacecraft	n.宇宙飞船
spaceship	n.宇宙飞船
spacious	adj.广大的，宽敞的
span	n.跨度；一段时间 vt.跨越
spangle	v.（使）闪烁
spanking	adj.强烈的，疾行的
spare	adj.多余的，备用的 vt.节约，节省 n.剩余，备用品
sparingly	adv.节俭地，保守地
spark	n.火花，火星 vt.发动，激起
sparrow	n.麻雀
sparse	adj.稀少的；稀疏的
sparsely	adv.稀疏地，稀少地
spawn	v.产卵，大量生育 v.造成，酿成
specialized	adj.专业的，专门的
species	n.类群，种类
specific	adj.具体的，特指的
specification	n.规格，详细说明书
specified	adj.特定的
specify	vt.明确说明；具体指定
specimen	n.标本，样品
speck	n.斑点
spectacle	n.奇观；展示，景象
spectacular	adj.引人入胜的，壮观的
spectacularly	adv.引人入胜地
spectator	n.参观者，观众
spectra	n.光谱
spectrum	n.谱，光谱
speculate	v.推测；沉思
speedy	adj.快的，迅速的
sphere	n.球体
spherical	adj.球的，球状的
spill	vi.溢出 n.溢出，溅出
spinach	n.菠菜
spinal	adj.脊骨的，脊髓的
spine	n.脊骨；书脊；刺
spined	adj.有脊骨的，有脊柱的
spinet	n.小型立式钢琴
spinning	adj.旋转的
spiny	adj.多刺的，刺状的
spiral	adj.螺旋形的，盘旋的 v.盘旋
spiritual	adj.精神上的
splash	v.溅，泼
splendor	n.壮丽，辉煌
split	v.劈开，（使）裂开；分开
spoil	v.损坏；腐烂 v.宠爱，溺爱
spoilage	n.（食物等）变质，损坏
sponge	n.海绵
spontaneity	n.自然，自发
spontaneous	adj.自发的，自然产生的
spontaneously	adv.自然地, 本能地
spoon	n.匙，勺子
sporadically	adv.偶发地, 零星地
spot	n.地点，场所 v.发觉，发现
spotless	adj.没有污点的
spotlight	v.强调，突出     n. 重点
sprawl	vi.散乱地延伸 vi.四肢摊开着坐、卧或倒下 n.扩展，蔓延
spray	n.喷雾，飞沫 vt.向…喷射，喷
spring	n.泉；弹簧 v.跳跃
springtime	n.春天，春季
springwater	n.天然泉水
sprout	vi.长出，萌芽
spur	n.踢马刺 vt.刺激，鞭策
squarely	adv.坚实的，坚固地
squash	n.南瓜 v.压碎，挤压；镇压
squeeze	vt.榨；挤进，塞进
squirrel	n.松鼠
squirt	vi.喷出，溅进
stability	n.稳定性
stabilize	vt.使稳定，使坚固
stable	adj.稳定的，相对固定的
stack	vt.堆积 n.堆
staff	n.全体人员或职员
stagecoach	n.公共马车
stagger	vi.蹒跚，摇晃
staggering	adj.巨大的，惊人的
stagnant	adj.停滞的, 迟钝的
stain	n.污点，瑕疵
stained	adj.污染的，玷污的
staircase	n.楼梯
stalk	vt.隐伏跟踪（猎物） n.茎，柄，梗
stamina	n.体力，耐力
stand	vt.站立；忍受，容忍
standard	n./adj.标准（的）
standardize	vt.使符合标准，使标准化
standardized	adj.标准化的
standing	adj.固定的，常设的 n.身分，名望
standpoint	n.立场，观点
stanza	n.（诗）节，段
staple	n.主要产品，日常必需品 adj.主要的，常用的 vt.把…订起来
starch	n.淀粉；淀粉食物
stardom	n.明星的身份或地位
starfish	n.海星
stark	adj.光秃秃的；荒凉的
starvation	n.饥饿，饿死
starve	v.挨饿
stash	vt.藏或贮存于一秘密处所 n.隐藏处
stately	adj.庄严的，堂皇的
stationary	adj.固定的；静止的
stationery	n.文具
statistics	n.统计学
statue	n.雕像
stature	n.身高，身材；声望，地位
status	n.状况；身份，地位
steadfast	adj.坚定的，坚信的
steady	adj.稳的，牢固的 adj.持续的
steak	n.(供煎, 烤等的)肉, 牛排
steep	adj.险峻的，陡峭的 v.浸，泡；沉浸
steer	v.驾驶，掌舵
stellar	adj.星的，星球的
stem	n.（植物的）茎 v.来源于，基于 stem from
stereophotograph	n.立体摄影，立体相片
sterile	adj.贫瘠的；不育的 adj.消过毒的
stern	adj.苛刻的，严格的；严厉的
stick	n.棍，棒；手杖 v.粘住，粘贴 v.stick to 坚持
stickpin	n.领带夹
sticky	adj.粘的，粘性的
stiff	adj.硬的，僵直的 adj.（态度、举止）拘谨的
stiffen	vt.使硬，使僵硬
stifle	vt.使窒息；扼杀，抑制
stilt	n.高跷，支柱
stimulant	n.刺激物，兴奋剂
stimulate	vt.刺激，激励，激发
stimulation	n.激励，鼓舞，刺激
stimuli	n.stimulus复数
stimulus	n.刺激；刺激物
sting	v.刺；刺痛
stipend	n.薪贴；奖学金；养老金
stipulate	vt.约定，规定
stipulation	n.规定，条款
stitch	v.缝
stocky	adj.(人或动物)矮而结实的，粗壮的
stonemason	n.石工，石匠
stout	adj.结实的，勇敢坚定的
strain	n.过度的疲劳，紧张 n.血统；物种 vt.过滤
strand	n.绳、线之一股
strap	v.用带缚住, 用带捆扎
strata	n.地层（复数）
stratum	n.地层（单数）；阶层
strengthen	vt.加强，巩固
strenuous	adj.费力的；艰辛的
strenuously	adv.奋发地，费力地
stretch	v.伸展，伸长
stride	n.大步，一跨步
strike	n./v.罢工，打击
striking	adj.醒目的，惊人的
strikingly	adv.醒目地, 引人侧目地
string	n.（乐器的）弦；细绳，带子
stringent	adj.严厉的 adj.缺钱的，银根紧的，周转困难的
strings	n.弦乐器
strip	vt.剥夺；剥掉 n.条，带
stripe	n.斑纹，条纹
strive	vi.努力，奋斗；力求
stroke	n.（绘画等）一笔；一击
stubborn	adj.顽固的，固执的
stubbornness	n.倔强，顽强
studio	n.录音室；艺术家工作室
stumble	vi.绊倒
stun	vt.使晕倒，打晕；使震惊
stunning	adj.令人惊叹的，极好的
stunt	n.惊人表演，绝技；特技 vt.阻碍…发育，妨碍…生长
sturdy	adj.(人)强健的，结实的；(物)稳固的
stylized	adj.风格化的，程式化的
subdiscipline	n.（学科的）分支，分科
subdivision	n.细分，一部
subduct	v.减去，除去
subdue	vt.征服
subjected	adj.服从的，隶属的
submarine	n.潜水艇，潜艇 adj.水下的，海底的
submerge	v.（使）沉没，淹没
submerged	adj.在水中的，淹没的
submit	v.服从 v.提交，递交
subsection	n.分部，分段
subsequent	adj.随后的，后来的
subsequently	adv.随后
subside	v.平息，减退
subsidiary	n.支流；子公司
subsidize	v.补助，资助
subsidy	n.补助金，津贴
subsist	vi.生存，存在，供养
subsistence	n.生存；生计；存活
subspecies	n.[生]亚种
substantial	adj.相当的，可观的 adj.坚固的
substantially	adv.相当多地，大大地
substantiate	vt.证实，加强
substantive	adj.真实的，有实质的
substitute	vt.代替 n.代替者，代替品
subterranean	adj.地下的，地表下的
subtle	adj.微妙的，细微的
subtract	v.减去   ~ from
subtraction	n.减少 n.减法
subtractive	adj.减法的；负的
suburb	n.郊区
suburbanite	n.郊区居民
suburbanization	n.近郊化，郊区建造
subversive	adj.颠覆性的，破坏性的
successive	adj.连续的，相继的
succinct	adj.简明的，简洁的
succumb	vi.屈服，屈从
sue	v.向…请求，请愿 v.提出诉讼，控告
sufficient	adj.足够的，充足的
suit	vt.适合，适应
suitable	adj.适当的，相配的
suitcase	n.手提箱, 衣箱
suite	n.一批，一套，组
suited	adj.适合的，匹配的
summit	n.山顶，顶点
sumptuous	adj.奢侈的，华丽的
sun-bronzed	adj.被太阳晒成古铜色的
sunburn	n.晒斑, 晒黑
sundial	n.(通过太阳知道时间的) 日规, 日晷
sunflower	n.向日葵
sunglasses	n.太阳镜；墨镜
sunlight	n.日光，阳光
sunlit	adj.被日光照射了的, 阳光照射的
sunrise	n.日出
sunset	n.日落
sunshine	n.阳光
superb	adj.极好的，超级的
supercontinent	n.（地理）超大陆
superficial	adj.肤浅的，表面（上）的
superficially	adv.浅薄地
superintendent	n.主管，负责人
superior	adj.级别或地位更高的；质量或价值更好的
supernatural	adj.超自然的，神奇的
supervise	vt.监督，指导
supervision	n.监督，管理
supervisor	n.主管，管理人
supplant	vt.排挤；取代
supple	adj.柔软的，灵活的；柔顺的
supplement	vt.增补，补充 n.增补，补充
supplementary	adj.补充的
supplementation	n.增补，补充
suppose	vt.推想，假设
supposedly	adv.按说，应该i
supposition	n.假定
suppress	vt.镇压，抑制
supremacy	n.至高无上的权力
supreme	adj.(权力、级别或地位)至高的；最重要的
supremely	adv.无上地，崇高地
surcharge	n.增付的费用，附加费
surface	n./adj.表面（的） vi.浮现出来，暴露
surge	n.汹涌，澎湃，喷发
surgeon	n.外科医生
surgery	n.外科；手术室
surging	n.汹涌
surmount	vt.克服；登上；越过
surpass	vt.超越，胜过
surpassingly	adv.卓越地，超群地
surplus	n.过剩，剩余（物资） adj.过剩的
surrender	v.交出，放弃；投降
survey	n./v.调查
survivability	n.存活率，生命力
survival	n.生存，幸存
survive	vi.(人)幸免于难,活下来；(物)耐久
survivor	n.生还者，残存物
susceptible	adj.易受影响的；敏感的，过敏的
suspect	adj.令人怀疑的，不可信的 vt.怀疑，猜想
suspend	vt.吊，悬挂 vt.延缓
suspender	n.吊裤带
suspense	n.悬念，情节
suspicion	n.怀疑
suspicious	adj.可疑的；好猜疑的
sustain	vt.维持；支撑
sustained	adj.持续不变的
sustenance	n.食物，生计
swallow	v.吞下，咽下 n.燕子
swamp	n.沼泽，湿地
swampy	adj.沼泽的，湿地的
swarm	n.蜂群，一大群 v.挤满，密集
sway	vi.摇摆，摇动 vt.使转变，说服
sweep	v.席卷，扫过 v.清扫，打扫 n.伸展，延伸
sweeping	adj.彻底的，广泛的
swell	vi.（使）肿胀、膨胀
swelling	n.肿胀
swift	adj.迅速的，敏捷的
swiftness	n.迅速，敏捷
syllable	n.（语音）音节
symbiosis	n.共生（关系），共栖
symbiotic	adj.共栖的，共生的
symbol	n.符号，记号；象征
symbolism	n.象征主义；符号论
symbolize	v.象征
symbology	n.象征学
symmetrical	adj.对称的
symmetry	n.对称（性），匀称
sympathetic	adj.有同情心的 adj.赞成的，合意的
sympathize	v.同情，体谅
sympathy	n.同情，同情心
symphony	n.交响乐，交响曲
symptom	n.症状；征兆
synchronize	vt.同步，同时发生
synonym	n.同义字
synonymous	adj.同义的
synthesis	n.综合, 合成
synthesize	vt.综合；合成
synthesizer	n.[电子]合成器
synthetic	adj.合成的，人造的 n.合成物质
syrup	n.糖浆，果汁
system	n.系统，体系
systematic	adj.系统的，体系的
systematize	v.使系统化；将…分类
tableland	n.高原
tableware	n.餐具
tactics	n.战术；策略
tactile	adj.触觉的；可触觉的
tadpole	n.[动]蝌蚪
tag	vt.给…加标签；添加，附加 n.标签，货签
tailor	n.裁缝师
taint	n.污点，瑕疵 vt.污染；玷污
talent	n.才能；天才
talented	adj.有天才的，有才能的
tally	v.符合，吻合 n.记录；记账
tame	vt.驯养，驯服 adj.（动物）驯服的，柔顺的
tap	vt.开发，利用
tapering	adj.尖端细的
tapestry	n.织锦, 挂毯
tapeworm	n.[动]绦虫
tardiness	n.迟到；缓慢
tardy	adj.迟到的；缓慢的
tariff	n.关税
tarnish	n.晦暗，污点 vt.使失去光泽；玷污
taste	v.品尝，辨味 n.味道，味觉 n.品味，兴趣
tasteless	adj.没味道的
tasty	adj.美味的，可口的
tavern	n.小酒店；客栈
taxicab	n.出租车
teapot	n.茶壶
tectonics	n.[地]构造地质学
tedious	adj.单调乏味的，沉闷的
tedium	n.单调乏味
telecommuter	n.（通过在线方式）远距离工作者
telegraph	n.电报机；电报
telescope	n.望远镜
temper	n.脾气，性情 vt.缓和，调节
temperance	n.节制，自制；戒酒；禁酒
temperate	adj.（气候等）温和的 adj.(欲望、饮食等)适度的,有节制的
temperature	n.温度
temple	n.寺庙，教堂
temporarily	adv.临时
temporary	adj.短暂的，暂时的
tempt	vt.诱使
tempting	adj.诱惑人的
tenant	n.承租人，房客
tendency	n.趋势，倾向
tender	adj.嫩的，柔软的
tenderness	n.亲切，温柔
tenement	n.出租给房客的住房；(穷人)公寓
tense	adj.紧张的，拉紧的
tensile	adj.可拉长的, 可伸长的
tension	n.紧张（状态），压力
tentacle	n.触角，触须，触手
terminal	n.总站，终点站 n.（电脑）终端，接线端
terminate	v.停止，结束
termination	n.终止，结束
terminology	n.用辞，术语
terminus	n.（火车、汽车）终点站
termite	n.白蚁
terrace	n.梯田，台地；阳台 vt.使成梯田
terrain	n.地势，地形
terrestrial	adj.地球（上）的；陆地的
terribly	adv.可怕地，十分
terrific	adj.极好的
terrify	vt.使恐怖，使惊吓
terrifying	adj.恐怖的
textile	n.纺织品
texture	n.质地；（材料等）结构
textured	adj.手摸时有感觉的, 有织纹的
thatch	vt.用茅草覆盖屋顶
thaw	n.解冻 v.解冻，融化
theft	n.偷窃
theist	n.有神论者
theme	n.(谈话, 写作等的)题目, 主题
theoretical	adj.理论上的
thereby	adv.因此，从而
therefore	adv.因此，所以
thermal	adj.热的, 热量的
thermodynamics	n.热力学
thesis	n.论题，论文
thigh	n.大腿
thorn	n.[植]刺, 棘
thorny	adj.有刺的；多刺的
thorough	adj.完全的，彻底的
thoughtful	adj.体贴的，考虑周到的 adj.有思想性的
thousandfold	adj.千倍的
thread	n.线
threadlike	adj.线状的
threaten	vt.威胁；预示…的凶兆，可能来临
threateningly	adv.胁迫地
three-dimensional	adj.三维的, 立体的
threshold	n.开始，开端
thrifty	adj.节省的，节俭的
thrive	vi.繁荣，兴旺；茁壮成长
thrust	n.推力，冲 vt.插入，用力刺
thunderstorm	n.暴风雨
tide	n.潮汐；潮流
tilt	n.倾斜
timber	n.木材，木料
time-consuming	adj.费时间的
timid	adj.胆怯的，羞怯的
timidity	n.胆怯
tinplate	n.镀锡铁皮, 马口铁
tint	vt.给…着色；染 n.色彩
tip	n.顶，尖端 n.小费
tissue	n.[生]组织 n.绵纸，薄纸
toe	n.趾，脚趾，足尖
toed	adj.有趾的
tolerance	n.忍受，宽容
tolerant	adj.容忍的；宽容的
tolerate	vt.忍受；容许
topographical	adj.地形学的
topography	n.地形；地形学
topsoil	n.表层土
tornado	n.旋风，龙卷风
torpor	n.迟钝，不活泼
torque	n.扭矩
torrent	n.连发，迸发 n.骤雨；急流，洪流
torrential	adj.奔流的，如急流的
tortuous	adj.曲折的, 转弯抹角的
touchdown	n.着地，降落
touched	adj.被感动的
touching	adj.动人的，令人感伤的
tough	adj.坚硬的；坚强的 adj.艰苦的 adj.坚韧的；严格的,严格执行纪律的
tournament	n.比赛，锦标赛
tow	v.拖引，牵引 n.拖，拽
tower	n.塔，城堡
towering	adj.高耸的；杰出的
toxic	adj.有毒的，中毒的
trace	n.痕迹 vt.跟踪；追溯
track	n.轨道，路经   v. 追踪
tract	n.广阔的地面，大片（土地） n.管道
traction	n.牵引
tractor	n.拖拉机
tragedy	n.[戏剧]悲惨；悲惨之事
trail	n.踪迹，小路   v. 追踪
trainload	n.列车载重
trait	n.特征，特性
trample	vt.踩踏；蹂躏
tranquil	adj.宁静的，安静的
tranquility	n.宁静，安静
transaction	n.交易
transcend	vt.超出，超越
transcontinental	adj.横贯大陆的，大陆那边的
transcript	n.抄本
transfer	v.转移；转学
transform	vt.（使）变形，改观
transformation	n.转变；变形
transition	n.转变，过渡
translucent	adj.半透明的；透明的
transmit	v.传送，传播
transmitter	n.传送者，发送器
transmute	vt.使变化，使改变
transparent	adj.透明的
transplant	v.移植
trap	v.捕捉，困住；陷害 n.圈套，陷阱
trapper	n.设阱捕兽者
trash	n.垃圾，废物
tray	n.碟，盘子
treacherous	adj.不可靠的，有暗藏的危险的 adj.背叛的，背信弃义的
tread	vi.踏，践踏；行走
treadmill	n.踏车
treason	n.叛逆，叛国
treatment	n.待遇，对待 n.处理，治疗
tremendous	adj.巨大的，惊人的
trench	n.沟，壕沟
trend	n.倾向，趋势
trespass	vt.侵犯，闯入私人领地
trespasser	n.侵犯（他人土地）者
trial	n.实验 n.审讯
tribal	adj.部落的，宗族的
tribe	n.部落，部族
tributary	adj.辅助的，支流的 n.支流
tribute	n.贡品，礼物 n.颂词，殷勤
trickle	vi.滴；细流
trigger	vt.引发，引起，触发
trilogy	n.三部剧，三部曲
trim	vt.修剪，整饰
triumph	n.胜利 vi.获得胜利，成功
trivial	adj.微不足道的，琐碎的
tropical	adj.热带的
troublesome	adj.讨厌的，麻烦的
troubling	adj.令人不安的，令人忧虑的
troupe	n.剧团
trove	n.被发现的东西，收藏的东西
trumpet	n.喇叭
trumpeter	n.喇叭手，号兵
trustworthy	adj.可信赖的
tub	n.桶，浴盆
tube	n.管子；电子管，显像管
tuition	n.学费
tumble	v.翻滚   n. 平脚杯
tundra	n.苔原，冻土地带
tunnel	n.隧道
turbulence	n.喧嚣，骚乱
turbulent	adj.吵闹的；狂暴的
turnpike	n.公路，收费高速公路
turquoise	n.绿宝石
tutor	vt.辅导；当…的家庭教师 n.家庭教师
tutorial	n.个别指导
twig	n.细枝，嫩枝
twine	v.搓，织，编饰；(使)缠绕
twist	n./v.扭曲，拧
tycoon	n.大企业家，大亨
typical	adj.典型的；有代表性的
typify	vt.代表，为…之典型
tyrannical	adj.暴虐的，残暴的
ultimate	adj.最终的，最后的
ultimatum	n.最后通牒
ultrasonic	adj.超音速的，超声（波）的
ultrasonics	n.超音波学
ultraviolet	adj.紫外线的
unadorned	adj.未装饰的,朴实的
unanimity	n.全体一致，一致同意
unanimous	adj.全体意见一致的
unbearable	adj.无法忍受的，承受不住的
unbiased	adj.没有偏见的
unbridgeable	adj.不能架桥的, 不能逾越的
unbridled	adj.放纵的，无约束的
unbroken	adj.完整的；持续的
uncharted	adj.地图上没标明的
unconscious	adj.不省人事的；无意识的
unconventional	adj.非传统的，与先前不同的
unconvincing	adj.不足以令人相信的
uncover	v.发现，揭示
underdeveloped	adj.不发达的
underestimate	v.低估
undergo	v.经历，遭受
undergraduate	n.(尚未取得学位的)大学生
underground	adj.地下的，地面下的
underlie	vt.位于...之下, 成为...的基础
underlying	adj.基础的；在下面的
undermine	v.渐渐破坏，暗地里破坏
underneath	prep.在…的下面
underscore	v.划线于…下，强调
undertake	v.从事，承担
undertaking	n.任务；事业
underwater	adj.在水下的，在水中的
undeserved	adj.不应得的，不该受的
undifferentiated	adj.无差别的，无显著特征的
undistorted	adj.未失真的
undisturbed	adj.没受干扰的，安静的
undo	v.解开，松开 v.逆转或清除；取消
undoubtedly	adv.毋庸置疑地，确凿地
unearth	vt.发觉，挖出；揭露
unemployed	adj.失业的
unevenly	adv.不平坦地；不均衡地
unexplored	adj.未开发的，未探索的
unfair	adj.不公平的
unfavorable	adj.不宜的；相反的
unfertilized	adj.未施肥的，未受精的
unfold	v.打开，显露
unfortunately	adv.不幸地
uniform	n.制服 adj.统一的；始终如一的
uniformity	n.同样，一式
unify	vt.统一，使成一体
unimaginable	adj.不可想象的
uninhabited	adj.无人居住的
unique	adj.独一无二的；独特的
uniqueness	n.独特，独一无二
unity	n.结合，一致
universal	adj.宇宙的 adj.普遍的；共同的
universe	n.宇宙，世界
unload	vt.摆脱…的负担，卸
unmatched	adj.无可匹敌的
unobstructed	adj.畅通无阻的
unpack	v.打开包裹（或行李）
unpalatable	adj.味道差的, 不好吃的
unparalleled	adj.无比的，空前的
unprecedented	adj.前所未有的，空前的
unpredictable	adj.不可预知的
unpromising	adj.无前途的, 没有希望的
unquestionably	adv.无疑地，无可非议地
unquestioning	adj.不加疑问的,不犹豫的
unravel	v.弄清楚（秘密） v.拆开；解开；松开
unrestrained	adj.无限制的
unrestricted	adj.无限制的, 自由的
unsatisfactory	adj.令人不满意的
unscrupulous	adj.肆无忌惮的, 无道德原则的
unscrupulously	adv.肆无忌惮地，无道德的
unseasonably	adv.不合时令地，不合时宜地
unselfish	adj.不自私的, 慷慨的
unsophisticated	adj.不懂事故的，单纯的
unspoiled	adj.未损坏的
unstable	adj.不稳定的
unsubstantiated	adj.未经证实的
untamed	adj.未驯服的
untapped	adj.未使用的
untouched	adj.未触及的
unwieldy	adj.笨拙的；(因太大、太重、形状奇特等)不易被移动的，笨重的
upgrade	v.使升级，提升
upheaval	n.剧变
uphold	v.维护，支持
upland	n.丘陵地带，高地
uproot	v.连根拔起，拔除 v.根除,灭绝；赶出家园,被迫移开
upscale	adj.高消费阶层的
upset	adj.心烦意乱的 v.颠覆，推翻；扰乱
upside-down	adj.颠倒的
urban	adj.城市的
urbane	adj.温文尔雅的
urbanism	n.都市生活, 都市化
urbanite	n.都市人
urbanization	n.都市化，文雅化
urbanize	vt.使都市化，使文雅
urge	v.催促；力劝，恳求 n.冲动
urgency	n.紧急情况
urgent	adj.紧急的，迫切的
utensil	n.器具
utilitarian	adj.功利的；实利的
utility	n.公用事业公司；公用事业设备 n.运用，效用
utilization	n.利用
utilize	v.利用
utopian	adj.乌托邦式的，空想的
utter	v.做声；发表 adj.全然的，完全的
utterance	n.说话，说话的方式
utterly	adv.完全地，绝对地
vacancy	n.空白，空缺
vacant	adj.空的，未被占用的
vacate	vt.腾出，空出
vacation	n.度假，休假
vaccinate	v.进行预防接种
vaccine	n.疫苗
vacuum	n.真空
vague	adj.模糊的；含糊的
valid	adj.有效的；有根据的，正确的
validate	vt.使生效，确认，证实
validity	n.有效性，合法性
valve	n.活门，阀
vanish	vi.消失；灭绝
vapor	n.水汽，水蒸气
vaporization	n.蒸发
vaporize	v.（使）蒸发
variability	n.可变性
variable	n.[数]变数, 变量 adj.可变的, 易变的
variance	n.分歧；差异
variation	n.变异；变种
varied	adj.杂色的，各式各样的
variety	n.变化，多样性
various	adj.各种的
varnish	vt.涂上清漆，修饰 n.清漆
vast	adj.巨大的，大量的；范围广的
vastness	n.巨大
vault	n.拱顶；地下室
vaulted	adj.拱状的
vegetable	n.蔬菜
vegetarian	n.素食者
vegetation	n.植物，草木，植被
vehicle	n.交通工具, 车辆 n.媒介物, 传达手段
veil	vt.隐藏，遮蔽       n. 面纱
vein	n.静脉
veining	n.脉络分布；矿脉
velocity	n.速度；速率
venerable	adj.值得尊敬的，庄严的
veneration	n.尊敬, 崇拜
venom	n.(蛇的)毒液 n.恶意, 怨恨
venomous	adj.有毒的
vent	n.通风孔；出烟孔
ventilate	vt.使通风
ventilation	n.通风
venture	n.冒险（事业），投机活动
venturesome	adj.好冒险的；（行为）冒险的
venue	n.地点；会场
verbal	adj.口头的
verdict	n.[律](陪审团的)裁决
verify	vt.证明，证实
versatile	adj.多才多艺的 adj.通用的；可塑的，可变形的
verse	n.诗，韵文
version	n.译本，译文 n.一种描述
vertebrate	n./adj.脊椎动物（的）
vertical	adj.垂直的，竖直的
vessel	n.船 n.脉管 n.容器
vestige	n.痕迹，遗迹，残余
veteran	n.老兵；老手
veto	n.否决；否决权 vt.否决；禁止
viability	n.生存能力，发育能力
viable	adj.可行的，切实可行的 adj.能活下去的
vibrant	adj.活泼的；生气勃勃的
vibrate	v.颤动，震动
vibration	n.振动，颤动
vicinity	n.附近，接近
victor	n.胜利者；获胜者
victorious	adj.获胜的，胜利的
victory	n.胜利，战胜
victuosity	n.艺术鉴别力
videocassette	n.录像带
vie	v.竞争
vigilance	n.警戒，警惕
vigor	n.精力，活力
vigorous	adj.健壮的，精力旺盛的；有力的
vine	n.葡萄藤，蔓
violence	n.暴力，强暴
violent	adj.暴力引起的，暴烈的 adj.激烈的，强烈的
viral	adj.病毒的
virtually	adv.事实上，实质上
virtue	n.美德
virus	n.[微]病毒
viscosity	n.粘度，粘性
viscous	adj.粘滞的，粘性的
visibility	n.可见度
vision	n.视觉
vista	n.景色
vital	adj.极重要的，致命的
vitalism	n.活机论, 生机说
vitalist	n.活力论者
vitality	n.活力，生命力
vivid	adj.(光线、色彩)鲜艳的，强烈的 adj.生动的，逼真的
vocation	n.职业
vocational	adj.职业的
void	n.空白，空虚 adj.无效的
volatile	adj.挥发性的 adj.可变的，不稳定的
volcanic	adj.火山的
volcano	n.火山
voltage	n.电压
volume	n.体积，容积；量
voluntary	adj.自愿的；志愿的
volunteer	n.自愿者 v.自愿
voracious	adj.狼吞虎咽的，贪婪的
vote	vt.投票 n.投票，选票
voter	n.投票者，选举人
vowel	n.元音
voyage	n.旅行，航程
vulnerable	adj.易受攻击的；易受伤害的
wade	v.涉水，费力行走
wagon	n.四轮马车
waist	n.腰，腰部
waive	v.放弃；免除
walkout	n.罢工
walnut	n.胡桃，核桃树
wane	v.减少，衰落
ware	n.陶器，器皿
warehouse	n.仓库，货栈
warrantable	adj.可证明为正确的，可证实的
warranty	n.担保，保证；保修
warrior	n.战士，勇士
wary	adj.小心翼翼的，机警小心的
watercourse	n.水道，河道
waterproof	adj.防水的
wavy	adj.波状的，起浪的；波动的
wax	n.蜂蜡；蜡状物 v.上蜡于
waxy	adj.苍白的；光滑的
weapon	n.武器
weariness	n.疲倦
weary	adj.疲倦的；厌倦的
weather	v.风化
weathering	n.侵蚀，风化
weave	vi.迂回行进 vt.编织，组合
weaver	n.织布者，织工
weaverbird	n.[鸟]织巢鸟之一种
wed	v.娶，嫁，结婚
wedding	n.婚礼
wedge-shaped	adj.楔形的
weed	n.杂草
weep	vi.哭泣
weird	adj.怪诞的，奇异的
weld	v.焊接
welfare	n.福利
well-being	n.安宁，福利
whim	n.随意，冲动
whittle	v.削；削减
wholesale	adj.批发的 adj.大规模的
wholesaler	n.批发商
wholesome	adj.有益健康的
wildlife	n.野生动植物
willow	n.柳树
wingspan	n.[空]翼展
wit	n.智力，才智
withdraw	v.撤退 v.收回，撤销
withdrawal	n.收回；撤退，退回
wither	v.（使）枯萎，凋谢
withstand	vt.承受，抵住
witness	vt.目击；为…作证 n.证人
woods	n.森林
wool	n.羊毛
woolen	adj.羊毛制的；毛织品的
woolly	adj.多毛的
workload	n.工作量
worldwide	adj.全世界的
wrap	vt.裹，包，捆
wreck	n.失事；失事的残骸 vt.失事
wrestling	n.摔跤，格斗
wright	n.建造者，制造者
wring	vt.绞，拧，扭
wrinkle	n.皱纹，褶皱
wrist	n.手腕，腕关节
wristwatch	n.手表
yardstick	n.<美> 码尺, 准绳
yarn	n.纱，纱线
yawn	n.呵欠
yelp	vi.狗吠
yield	v.生产；产生 v.屈服；放弃；投降 n.产量；收益
yolk	n.蛋黄
zeal	n.热心，热情，热忱
zealous	adj.热心的；狂热的
zenith	n.顶点，顶峰
zigzag	adj.曲折的 adj.锯齿状的，Z字形的
zone	n.区域；地带
on account of	由于，因为
in addition to	除..之外
all but	adj. 几乎… n. 除…以外所有的
all inclusive	无所不包的
an army of	大群的，大量的
apart from	除…之外
as far as	就...来说；远及
as such	就象这样做，就本身而论
as a rule	通常，总的来说
as a rule of thumb	大概来说
assembly line	装配线，流水线
at intervals	不时；相隔一段距离
at one session	一下子，一次性
at the cutting edge of	在…的关键时刻/状态/位置
bald eagle	秃头鹰（美国国鸟）
barbed wire	带倒钩的铁丝（铁丝网）
be taken by	被迷住，被吓住
be up to	由…做；胜任，从事于
believe in	相信
belong to	属于
biological diversity	生物多样性
blast furnace	鼓风炉
boiling point	沸点
baby boom	生育高峰
break apart	分开，分裂
break all ties with	与…断绝一切关系
break out	爆发；发生
break up	分裂，分离
building block	积木
by a factor of	翻…倍
by chance	偶然
by far	迄今为止
log cabin	小木屋
cast off	丢弃，摆脱
cast away	使失事，使漂流
catch on	理解，领会
check out	检验，校验
civil rights	公民权
civil war	内战
code of laws	法典
comply with	遵从，符合
compound eyes	复眼
confined to bed	卧病不起的
confuse…with…	把…认为
contribute to	有助于，对…起作用
coral reef	珊瑚礁=corals
coupled with	加之，除…以外
the Red Cross	红十字会
critical point	临界点
a cushion of	一层
air-cushion vehicle	气垫船
dash off	水猛冲；感情爆发
date back	追溯到…
big deal	重大的事，重要的人
deal with	处理，应付
depend on	依靠，依赖
under the depressor	被强制
derive from	来源于
smoke detector	烟雾探测器
dispense with	免除，省却
dispose of	除去，扔掉；解决，处理
dividing line	分界线
draft animal	役用动物
down the drain	浪费；无结果
draw up	起草
draw out	拔出；引起
draw from	源于…
drop in	顺便拜访
due to	因为，由于
engage in	从事于，参加
real estate	房地产
express business	特快专递业务
express train	特快列车
feed on	吃，以…为食
fend for oneself	自己谋生
fertilized egg	受精卵
field research	野外实地考察
flock to	成群结队地去
follow suit	跟着做
from a far	从遥远的地方
get rid of	摆脱；除去
get in the way of	阻挡
give way to	让步，让路
go broke	破产
gold rush	淘金热
gravitational field	重力场
gravitational pull	地心引力
gravitational force	地心引力
grazing land	牧场，草场
hold a large stake	拥有巨额股份，带有极大冒险性
horror film/movie	恐怖电影
ice sheet	冰层
ice cream cone	冰淇淋蛋卷
immune system	免疫系统
in conjunction with	结合
in accord with	与…一致
in common	共有，有共同之处
in scale	相称，成比例
in terms of	根据；就…而论
be informed about	熟悉
inorganic chemical	无机化合物
jibe with	与…一致
labor movement	劳工运动
labor union	工会
equilateral triangle	等边三角形
learn by rote	死记硬背学习
liable of	倾向于
life span	寿命
light bulb	灯泡
living quarters	住房，住处
long-range	远程的
mistrustful of	不相信，怀疑
most distinctive	最杰出的，典型的
mud mortar	灰泥浆
native to	土生土长的
natural gas	天然气
nerve cord	脊髓
spinal cord	脊髓
not…so much as…	与其…还不如…
not as yet	迄今为止，还没有
now and then	不时
object to	反对
of scale	大规模的
owing to	因…之缘故
pack down	填塞，夯实
pack animal	能运输的动物
pave the way for	为…铺平道路
a pivotal figure	关键人物
popular tune	流行歌曲
postal service	邮政服务
presidential election	总统选举
preside over	主持
prime number	素数
pry open	撬开
news coverage	新闻报道
range from…to…	从…到…范围不等
regardless of	不管，不论
sea cucumber	海参
set aside for	专门留出时间做…
shuffle the deck	洗牌
skip class	旷课
slip one's mind	忘记
slow breeding	养育起来很慢的
social distinction	具有明显的社会身分或地位
solar cell	太阳能电池
stand in the way of	挡住…的道路
stock car racing	专业汽车比赛
subject to	服从
susceptible to	易受…影响
thrive on	在…中旺盛生长
to and fro	来来回回
treasure trove	无主埋藏物，无主珍宝
usher in	引发，产生
ward off	防止，挡住
waste disposal	废物处理
wear away	磨去
wear out	用坏，磨损
well organized	有组织的
whisk off	突然带走
wind up	结束，终止
yield to	屈服于…
